Hhd, Hhd, Hhd, Hhd, Mdd, Gg, Hhd, Hhd, Hhd, Hhd, Mdd^Xm, Hhd, Mdd^Xm, Hhd, Mdd^Xm, Hhd, Hhd, Gg, Hhd, Hhd, Hhd, Gg, Mdd, Gd, Gd^Fts, Gd
Hhd, Hhd, Hhd, Mdd, Mdd, Hhd, Hhd^Fts, Hhd, Mdd, Mdd^Xm, Mdd, Mdd^Xm, Mdd, Mdd^Xm, Mdd, Mdd^Xm, Mdd, Hhd, Hhd, Hhd, Mdd^Xm, Mdd^Xm, Mdd, Hhd, Hhd^Fts, Gd^Fts
Gd, Hhd, Gd, Hhd^Fts, Mdd, Hhd^Fts, Mdd^Xm, Mdd^Xm, Mdd^Xm, Mdd^Xm, Mdd, Mdd, Mdd, Mdd, Mdd, Mdd, Mdd, Mdd^Xm, Mdd^Xm, Mdd, Mdd^Xm, Mdd^Xm, Mdd, Hhd^Fts, Gd^Fts, Gd^Fts
Gd, Gd, Hhd, Gd, Gd, Mdd, Mdd^Xm, Mdd^Xm, Mdd, Mdd, Mdd, Hh, Rr^Vd, Gs, Gs^Edb, Mdd, Mdd, Mdd, Mdd^Xm, Mdd^Xm, Mdd, Mdd, Mdd, Hhd, Gd, Gd
Hhd, Hhd, Mdd, Mdd, Mdd, Mdd, Mdd^Xm, Mdd^Xm, Mdd, Hh, Rr^Edb, Rr^Edb, Rr^Edb, Rr^Es, Rd^Edb, Gs^Edb, 1 Rr^Dr, Gs^Edb, Mdd, Mdd^Xm, Hhd, Hhd, Hhd, Hhd, Gd, Gd
Hhd, Hhd, Hhd, Mdd, Mdd, Mdd, Mdd^Xm, Mdd, Mdd, Mdd, Rr^Edb, Rr^Edb, Hh, Gs^Es, Hh, Rd^Edb, Gs^Edb, Hh^Esd, Mdd, Mdd, Hhd, Gd, Gd, Gd, Hhd^Fts, Hhd
Hhd, Hhd, Mdd, Mdd, Mdd, Mdd, Mdd, Mdd, Rr^Dr, Rd, Rd, Gs, Gs^Es, Mv^Vd, Gs^Edb, Rr^Edb, Rr, Mdd, Hhd, Mdd, Hhd, Gd, Gd^Fts, Hhd^Fts, Hhd, Hhd
Hhd, Hhd, Mdd, Mdd, Mdd, Hhd^Fts, Mdd, Mdd, Mdd, Hh^Es, Hhd, 2 Rd, Rr^Edb, Hh, Rr^Edb, Rr^Edb, Gs, Hhd, Hhd, Hhd, Gd, Gd, Hhd^Fts, Hhd^Fts, Hhd, Hhd
Gd, Hhd, Mdd, Mdd, Mdd, Hhd, Hhd, Mdd, Mdd, Hhd^Es, Hhd, Rd, Rd^Edb, Rr^Edb, Rr^Edb, Rr^Edb, Rr^Dr, Mdd, Mdd, Hhd, Hhd, Gd, Gd, Hhd^Fts, Hhd, Hhd
Gd, Mdd, Gd, Gd, Hhd, Hhd, Wwrt, Mdd, Mdd, Mdd, Mdd^Dr, Hhd, Rr^Dr, Rr^Esd, Gs, Rr, Mdd^Edb, Mdd, Mdd, Gd^Fts, Gd^Fts, Gd, Gd, Hhd, Hhd, Hhd
Gs, Gs, Wwt, Hhd, Wwt, Wwrt, Hhd, Wwrt, Mdd^Xm, Mdd, Mdd, Mdd, Mdd, Hhd^Edb, Hhd^Edb, Gd^Edb, Gd^Edb, Mdd^Edb, Hhd^Edb, Gd^Fts, Gd^Edb, Gd, Gd, Gd, Gd, Gd
Wwt, Wwt, Gs, Wwt, Gd^Fts, Hhd^Fts, Hhd, Mdd^Xm, Mdd^Xm, Mdd^Xm, Mdd, Mdd, Hhd^Fts, Hhd, Hhd, Hhd^Edb, Gd^Edb, Rd, Rd, Hhd, Gd, Gd, Gd, Gd, Gd^Fts, Gd
Wwt, Wwt, Wwt, Gs, Gd, Hhd^Fts, Hhd, Mdd, Mdd, Mdd^Xm, Mdd^Xm, Mdd, Hhd^Fts, Hhd, Hhd^Edb, Hhd, Hhd^Edb, Gd^Edb, Gd, Rd^Edb, Rd, Rd, Rd, Gd, Gd, Gd
Wwt, Wot, Wot, Gs, Gd, Hhd, Hhd, Mdd, Mdd, Mdd, Mdd, Mdd, Mdd^Xm, Hhd^Fts, Mdd^Xm, Mdd, Mdd^Xm, Hhd, Hhd^Fts, Gd, Gd, Gd, Gd, Rd, Gd, Gd
Wwt, Wot, Wot, Gs, Gs, Hhd, Hhd, Hhd, Hhd, Wwrt, Hhd, Mdd, Mdd, Mdd, Mdd, Mdd^Xm, Mdd, Mdd, Mdd, Hhd, Hhd, Gd, Gd, Rd, Gd, Gd
Wwt, Wot, Wot, Wot, Wwt, Gs, Wwt, Hhd, Wwrt, Wwrt, Hhd, Hhd, Hhd, Hhd, Hhd, Hhd^Fts, Hhd^Fts, Mdd, Mdd, Hhd, Hhd, Gd^Fts, Gd^Fts, Rd, Rd, Gd
Gs, Wwt, Wwt, Wot, Wwt, Wwt, Gd^Fts, Wwt, Hhd, Hhd, Hhd, Hhd, Gs, Hhd^Fts, Gs, Hhd^Fts, Hhd, Hhd, Hhd, Hhd, Hhd, Gd^Fts, Gd, Gd, Gd, Rd
Gd, Gs, Gs, Wwt, Gs, Gd^Fts, Gd^Fts, Gd^Fts, Gd^Fts, Hhd, Gd, Hhd, Hhd, Gs, Gs, Gs, Gs, Hhd, Hhd, Hhd, Hhd, Hhd, Gd, Gd, Gd, Gd
Gd, Gd^Fts, Gd, Gs, Gd, Gd^Fts, Gd, Gd^Fts, Gd, Gd, Gd, Gd, Gd, Gd, Gd, Gd, Gd, Hhd, Hhd, Hhd, Hhd, Hhd, Gg, Gg, Gg, Gg