Hhd, Hhd, Hhd, Hhd, Mdd, Gg, Hhd, Hhd, Hhd, Hhd, Mdd, Hhd, Mdd, Hhd, Mdd, Mdd, Mdd, Dd^Es, Dd, Dd, Dd, Dd, Dd, Dd^Es, Dd^Es, Ds
Hhd, Hhd, Hhd, Mdd, Mdd, Hhd, Mdd, Hhd, Mdd, Mdd, Mdd, Mdd, Mdd, Mdd, Mdd, Mdd, Mdd, Dd^Es, Mdd, Dd^Es, Mdd, Dd, Mdd, 1 Dd^Es, Dd, Dd
Mdd, Mdd, Dd, Dd^Es, Mdd, Mdd, Mdd, Mdd, Mdd, Mdd, Mdd, Mdd, Mdd, Mdd, Mdd, Mdd, Mdd, Mdd, Mdd, Mdd, Mdd, Mdd, Mdd, Mdd, Mdd, Dd^Es
Hhd, Mdd, Dd^Es, Dd^Es, Hhd, Mdd, Mdd, Mdd, Mdd, Mdd, Mdd, Hhd, Hhd^Dr, Hhd, Ds^Edt, Mdd, Cdr, Cdr, Cdr, Mdd, Mdd, Mdd, Mdd, Dd, Dd, Dd
Hhd, Dd, Mdd, Mdd, Mdd, Mdd, Mdd, Mdd, Mdd, Hhd, Hhd, Rd^Esd, Rd^Edb, Rd^Edt, Rd^Edb, Rd^Edb, Cdr, Kdr, Cdr, Mdd, Dd^Es, Dd^Es, Hhd, Hhd, Hhd, Hhd
Hhd, Hhd, Hhd, Mdd, Mdd, Mdd, Mdd, Mdd, Mdd, Mdd, Rd^Vd, Rd^Edt, Mdd, Rd, Mdd, Rd^Edb, Rd^Edb, Cdr, Mdd, Mdd, Hhd, Dd, Dd^Es, Hhd, Hhd, Hhd
Hhd, Hhd, Mdd, Mdd, Mdd, Mdd, Mdd, Mdd, Hhd^Dr, Hhd, Rd^Esd, Rd^Edb, Mdd^Edb, Mv, Mdd^Edb, Rd^Edb, Rd^Edb, Mdd, Hhd, Mdd, Hhd, Dd^Es, Hhd, Hhd, Hhd, Hhd
Hhd, Hhd, Mdd, Mdd, Mdd, Hhd, Mdd, Mdd, Mdd, Hhd^Es, Hhd, 2 Rd^Edb, Rd^Edt, Mdd, Rd^Edb, Rd^Edb, Ds, Hhd, Hhd, Hhd, Rd, Dd, Hhd, Hhd, Hhd, Hhd
Hhd, Hhd, Mdd, Mdd, Mdd, Hhd, Hhd, Mdd, Mdd, Hhd^Es, Hhd, Rd^Edb, Hhd^Edb, Rd^Edt, Rd^Edb, Rd^Esd, Hhd, Mdd, Mdd, Hhd, Hhd, Gd, Gd, Hhd, Hhd, Hhd
Hhd, Mdd, Ds, Dd, Ds, Hhd, Wwt, Mdd, Mdd, Mdd, Mdd^Dr, Hhd, Hhd^Dr, Ds^Edt, Rd^Edb, Rd^Edb, Mdd^Edb, Mdd, Mdd, Hhd, Hhd, Gd, Gd, Hhd, Hhd, Hhd
Hhd, Hhd, Wwt, Ds, Wwrt, Wwt, Hhd, Wwrt, Mdd, Mdd, Mdd, Mdd, Mdd, Hhd^Edb, Hhd^Edb, Rd^Edb, Rd, Mdd^Edb, Hhd^Edb, Hhd, Gd, Hhd, Gd, Gd, Gd, Gd
Wwt, Wwt, Gs^Ftp, Wwt, Ds, Ds, Hhd, Mdd, Mdd, Mdd, Mdd, Mdd, Hhd^Fts, Hhd, Hhd, Hhd^Edb, Rd, Hhd, Rd, Hhd, Gd, Gd, Gd^Edpp, Gd, Gd, Gd
Wwt, Wwt, Gs^Ftp, Gs^Ftp, Hh, Dd, Hhd, Mdd, Mdd, Mdd, Mdd, Mdd, Hhd^Fts, Hhd, Hhd^Edb, Hhd, Hhd^Edb, Rd, Hhd, Rd^Edb, Rd, Rd, Rd, Gd, Gd, Gd
Wot, Wot, Ww^Ewf, Gs^Ftp, Gs^Ftp, Hh, Hhd, Mdd, Mdd, Mdd, Mdd, Mdd, Mdd, Mdd, Mdd, Mdd, Mdd, Hhd, Hhd^Fts, Gd, Gd, Gd, Gd, Rd, Gs, Gd
Wot, Wot, Ww^Ewl, Gs^Ftp, Gs^Ftp, Hh, Ds, Hhd, Ds, Wwrt, Hhd, Mdd, Mdd, Mdd, Mdd, Mdd, Mdd, Mdd, Mdd, Hhd, Hhd, Gd^Edpp, Gd, Rd, Gs, Gs
Wot, Wot, Wot, Ww^Ewl, Gs^Ftp, Gs^Ftp, Wwt, Ds, Wwt, Wwt, Hhd, Hhd, Hhd, Hhd, Hhd, Hhd^Fts, Hhd^Fts, Mdd, Mdd, Hhd, Hhd, Gd^Fts, Gd^Fts, Rd, Rd, Gs
Wwt, Wwt, Wwt, Wot, Wwt, Wwt, Gs^Ftp, Wwt, Hh, Hhd, Hhd, Hhd, Gd^Fts, Hhd^Fts, Gd^Fts, Hhd^Fts, Hhd, Hhd, Hhd, Hhd, Hhd, Gd^Fts, Gd^Edpp, Gs, Gs, Rd
Gs^Ftp, Wwt, Gs^Ftp, Wwt, Gs^Ftp, Gs^Ftp, Gs^Ftp, Gd^Fts, Gd^Fts, Hhd, Gd^Fts, Hhd, Hhd, Gd^Fts, Gd^Fts, Gd^Fts, Gd^Fts, Hhd, Hhd, Hhd, Hhd, Hhd, Gd, Gs, Gs, Gs
Gs^Ftp, Gs^Ftp, Gs^Ftp, Gs^Ftp, Gs^Ftp, Gs^Ftp, Gs^Ft, Gs^Ftp, Gs, Gd^Fts, Gs, Gd^Fts, Gd, Gd^Fts, Gd^Fts, Gd^Fts, Gd, Hhd, Hhd, Hhd, Hhd, Hhd, Gg, Gg, Gg, Gg
