Gd, Mdd, Mdd, Mdd, Mdd, Mdd, Mdd, Mdd, Hhd^Fts, Gd^Fts, Gd^Fts, Gd, Hhd, Gd, Hhd, Gd, Rd, Gd, Hhd, Hhd, Hhd, Gd
Mdd, Mdd, Mdd, Mdd, Mdd, Hhd^Fts, Hhd, Hhd, Gd^Fts, Gd^Fts, Mdd, Mdd, Hhd, Hhd, Hhd^Edpp, Gd, Rd, Gd^Edpp, Hhd^Edpp, Hhd, Mdd, Gd
Mdd, Mdd, Mdd, Mdd, Mdd, Mdd, Hhd, Hhd, Gd^Edpp, Gd^Fts, Mdd, Mdd, Mdd^Edpp, Hhd, Gd^Edpp, Gd, Rd, Ce^Vda, Hhd^Edpp, Hhd^Edpp, Mdd, Mdd
Mdd, Mdd, Mdd, Mdd, Mdd, Hhd^Fts, Hhd, Gd^Edpp, Gd^Edpp, Mdd, Mdd, Mdd^Edpp, Hhd, Hhd, Rd, Rd, Gd, Gd, Hhd, Mdd, Mdd, Mdd
Mdd, Mdd, Mdd^Vct, 1 Mdd^Vct, Mdd, Mdd, Hhd^Fts, Hhd, Gd, Mdd, Mdd, Hhd, Gd^Edpp, Gd^Edpp, Rd, Gd, Hhd, Hhd, Mdd, Mdd, Mdd, Mdd
Mdd, Mdd, Mdd, Mdd^Vct, Mdd, Mdd, Mdd, Mdd, Gd, Gd^Edpp, Hhd, Hhd, Rd, Rd, Gd, Gd^Edpp, Hhd, Mdd, Mdd, Mdd, Mdd, Mdd
Mdd, Mdd, Mdd, Mdd, Mdd, Mdd, Gs^Edpp, Gd^Edpp, Gd, Gd, Gd, Gd, Rd, Gd, Gd^Es, Hhd, Mdd, Mdd, Mdd, Mdd, Mdd, Mdd
Mdd, Mdd, Mdd, Mdd, Mdd, Mdd^Edpp, Gd^Edpp, Gd^Edpp, Gd, Ce^Vda, Rd, Rd, Gd^Edpp, Gd, Hhd, Hhd, Mdd, Mdd, Mdd, Mdd, Mdd, Mdd
Hhd, Mdd, Hhd, Mdd, Mdd^Edpp, Mdd^Edpp, Gd^Edpp, Gd, Gd, Rd, Gd, Gd, Hhd, Hhd, Mdd, Mdd, Mdd, Mdd, Mdd, Mdd, Hhd^Fts, Mdd
Gd, Hhd, Hhd, Gd^Fts, Gd^Fts, Gd^Fts, Gd^Fts, Gd^Edpp, Gd^Es, Rd, Rd, Gd, Gd, Mdd^Edpp, Mdd^Edpp, Mdd, Mdd, Mdd, Hhd^Fts, Hhd^Fts, Hhd^Fts, Hhd^Fts
Gd, Hhd, Gd^Fts, Gd^Fts, Hhd, Gd^Fts, Hhd, Gd^Fts, Gs^Es, Gd, Gd, Rd, Gd^Edpp, Mdd^Edpp, Mdd, Mdd, Mdd^Edpp, Mdd^Edpp, Hhd^Fts, Hhd^Fts, Mdd^Edpp, Hhd
Gd, Gd^Edpp, Gd^Fts, Hhd, Hhd, Hhd, Mdd, Mdd, Mdd, Gd, Gd, Rd, Gd, Gd^Edpp, Mdd, Mdd, Hhd, Mdd^Edpp, Hhd^Fts, Hhd^Fts, Hhd^Fts, Hhd^Fts
Gd, Gd^Edpp, Gd^Edpp, Hhd, Hhd^Fts, Mdd, Hhd^Fts, Mdd, Mdd^Edpp, Hhd, Gd, Rd, Gd, Gd^Edpp, Hhd, Mdd, Mdd, Hhd, Gd^Fts, Hhd^Fts, Hhd^Fts, Hhd^Fts
Gs^Edpp, Gd^Edpp, Gd, Hhd^Fts, Gs^Edpp, Gd^Fts, Hhd^Fts, Hhd, Hhd, Gd^Edpp, Rd, Rd, Hhd, Hhd, Hhd^Fts, Mdd, Mdd, Hhd^Edpp, Gd^Fts, Hhd^Fts, Hhd^Fts, Hhd^Fts
Gd^Fts, Gd^Fts, Gd^Fts, Gd, Gd^Fts, Gs^Edpp, Gs^Edpp, Gs^Edpp, Gd, Rd, Gd^Edpp, Gd^Edpp, Hhd, Hhd^Fts, Hhd^Fts, Mdd^Edpp, Hhd, Hhd, Gs^Vc, Gd^Fts, Hhd^Fts, Hhd^Fts
Gd^Fts, Gd^Fts, Gd^Fts, Gd^Fts, Gd, Gd, Gd, Gs, Rd, Rd, Gs, Hhd, Gs^Edpp, Hhd^Fts, Mdd^Edpp, Mdd^Edpp, Hhd^Fts, Gs^Edpp, Gs, Gd^Fts, Hhd, Hhd
Gd, Gd, Gd, Gd, Gd^Fts, Gd, Gd, Gd, Rd, Gs, Gs, Gs, Hhd, Hhd, Hhd, Hhd, Hhd, Gs, Hhd, Gs^Edpp, Gd^Fts, Hhd
Gd, Gd, Gd, Gd^Fts, Gd^Fts, Gd^Fts, Gs^Esd, Ce^Vda, Rd, Gs, Gs, Gs, Hhd^Fts, Hhd^Fts, Gd^Fts, Gd^Fts, Gd^Fts, Gd^Fts, Hhd, Hhd, Hhd, Hhd
Gd, Gd^Fts, Gd, Gs, Gs, Gs, Gs, Rd, Gd, Gd, Gd, Gd, Gd^Fts, Gd^Fts, Gd^Fts, Gd^Fts, Gd^Fts, Gd^Fts, Hhd^Fts, Hhd^Fts, Hhd, Hhd
Gd, Gd, Gd, Gs, Gd, Gs, Rd, 2 Rd, Gd, Gd, Gd, Gd^Fts, Gd, Gd, Gd, Gs, Gs, Hhd^Fts, Hhd, Hhd^Fts, Gd^Fts, Hhd
Gd, Gd, Gd, Gd, Gd, Gd, Rd, Gd, Gd, Gd, Gd, Gd, Gd, Gd, Gd, Gs, Gd, Hhd, Gd, Gd^Fts, Gd, Hhd