Mdd, Gd, Mdd, Hhd, Hhd, Hhd, Hhd, Hhd^Fts, Hhd, Gd, Gd^Fts, Gd^Fts, Gs^Fts, Gs^Fts, Gs^Fts, Gs^Fts, Gs^Fts, Gs^Fts, Gs^Fts, Gd, Gs, Rd, Rd, Gs, Gs^Fts, Gs, Gs^Fts, Gd, Hhd, Hhd, Hhd, Hhd, Mdd, Gd, Mdd, Hhd, Mdd
Mdd, Mdd, Mdd, Mdd, Hhd, Hhd, Mdd, Hhd, Hhd, Hhd, Hhd, Hhd^Fts, Gs^Fts, Gs^Fts, Gs, Gs, Gs^Fts, Gs^Fts, Gs^Fts, Gs, Gs, Rd, Rd, Gs^Vh, Gs^Fts, Gs^Fts, Hhd^Fts, Hhd, Hhd, Hhd, Hhd, Mdd, Mdd, Mdd, Mdd, Mdd, Mdd
Mdd, Mdd, Mdd, Mdd, Hhd, Hhd, Hhd, Mdd, Mdd, Hhd, Hhd^Fts, Gs^Fts, Gs^Fts, Gd^Edpp, Gs^Fts, Gd, Gd, Gd^Edpp, Gs^Fts, Gs^Fts, Gs, Gs, Rd, Gs^Edpp, Gs^Fts, Gs^Fts, Hhd, Hhd, Hhd, Hhd, Mdd, Mdd, Mdd, Mdd, Mdd, Mdd, Mdd
Hhd, Dd, Mdd, Hhd, Mdd, Hhd, Mdd, Mdd, Mdd, Hhd, Hhd, Gs^Fts, Hhd^Fts, Gs^Fts, Mdd, Hhd, Hhd, Gd, Gd, Gs, Gs, Rd, Gs, Gs, Gs, Hhd^Fts, Hhd, Hhd, Hhd, Hhd, Mdd, Mdd, Ds^Es, Ds^Es, Ds^Es, Ds, Ds^Es
Mdd, Dd, Dd, Ds, Mdd, Mdd, Mdd, Mdd^Xm, Mdd^Xm, Mdd, Hhd, Hhd^Fts, Hhd, Mdd, Mdd, Mdd, Hhd, Gd, Gd^Vhr, Gs, Rd, Rd, Gs, Gs, Hhd, Hhd, Mdd, Mdd, Hhd, Hhd, Hhd, Mdd, Dd, Dd^Es, Mdd, Dd^Es, Ds
Mdd, Ds, Dd, Mdd, Mdd, Mdd, Hhd, Mdd, Mdd, Mdd^Xm, Mdd, Mdd, Hhd, Hhd, Hhd, Hhd, Gd, Gd, Gs, Rd, Gs, Gs, Gd^Fts, Hhd, Gd^Fts, Mdd, Mdd, Mdd, Mdd, Hhd, Hhd, Hhd, Ds, Dd^Es, Mdd, Mdd, Mdd
Mdd, Mdd, Dd^Do, Mdd, Mdd, Hhd, Gd^Vhr, Mdd, Mdd, Mdd, Mdd, Hhd, Hhd, Hhd, Hhd^Fts, Gd, Gd^Fts, Gd^Fts, Gd, Rd, Gs, Gd^Edpp, Gd^Fts, Gd^Fts, Hhd, Mdd, Hhd, Hhd, Hhd, Hhd, Gd, Gd, Gd, Hhd, Mdd, Mdd, Mdd
Hhd, Mdd, Re^Gvs, Re^Gvs, Re^Gvs, Gd, Gd, Hhd, Mdd, Mdd, Hhd, Hhd, Hhd^Fts, Gd^Fts, Gd^Fts, Gd^Edpp, Gd, Gd^Fts, Gs, Rd, Rd, Gd, Gd, Gd^Vc, Gd^Fts, Mdd, Hhd, Hhd^Fts, Hhd^Fts, Hhd, Gd, 1 Gd, Gd, Mdd, Hhd, Mdd, Hhd
Hhd, Hhd, Gd^Vc, Re^Gvs, Ce, 2 Ke, Ce, Gd, Gd^Vhr, Mdd, Hhd, Hhd, Gd^Fts, Gd^Fts, Gd^Fts, Gd^Fts, Gd, Gd^Edpp, Gs, Gs, Rd, Rd, Rd, Gd, Gd, Hhd, Hhd^Fts, Gd^Fts, Gd^Fts, Gd^Fts, Gd, Gd, Hhd, Mdd, Hhd, Hhd, Dd
Mdd, Hhd, Hhd, Gd, Rd^Edt, Ce, Rd, Rd, Hhd^Fts, Mdd, Hhd^Fts, Gd^Fts, Gd^Fts, Hhd, Gd^Vc, Gd, Gd, Gd^Fts, Gd, Rd, Gd, Gd, Gd, Rd, Gd, Gd, Gd^Edpp, Gd^Fts, Gd^Fts, Gd, Gd, Gd, Hhd, Hhd, Dd, Dd, Dd
Mdd, Mdd, Hhd, Hhd, Gd^Edt, Rd^Edt, Rd, Hhd^Fts, Hhd^Fts, Ce, Gd^Fts, Gd^Fts, Gd, Gd, Gd^Edt, Gd^Edt, Gd, Gd, Rd, Rd, Gd^Edt, Gd^Vhr, Gd, Rd, Rd, Gd, Gd, Gd^Fts, Gd^Edpp, Gd^Fts, Gd, Gd, Rd, Ds, Dd, Dd, Dd
Hhd, Hhd^Fts, Gd^Fts, Ce, Gd, Rd, Rd, Ce, Rd, Gd^Edpp, Gd, Gd^Fts, Rd, Rd, Rd, Rd, Rd, Rd, Gd, Gd, Gs, Gs, Gs, Gd, Gd, Rd, Rd, Gd, Gd, Gd, Gd, Gd, Ds, Ds, Dd, Dd, Dd
Hhd, Hhd^Fts, Gd^Fts, Gd^Fts, Gd^Fts, Ce, Gs, Rd, Gd^Fts, Rd, Rd, Rd, Gd^Fts, Gd, Gd, Gd, Gd, Gd, Gd, Gd, Gd, Gd, Gd, Gd, Gd, Gd, Rd, Gd, Gd, Gd, Gd, Dd, Dd, Dd, Dd, Dd, Dd
Hhd, Gd^Fts, Gd^Fts, Gd^Fts, Gd^Vhr, Gs^Edt, Gs, Gd^Edpp, Gd^Fts, Gd, Gs, Gd^Edpp, Gd^Fts, Gd^Edpp, Gd, Gd, Gd, Gd, Ds, Gd, Rd, Rd, Rd, Gd, Ds, Ds, Rd, Gd, Dd^Edp, Dd, Dd, Dd, Dd, Dd, Dd, Dd, Dd^Esd
Gd, Gd^Fts, Gd^Edpp, Gd^Fts, Gs, Gs, Gs, Gd^Fts, Gd^Fts, Gd^Edpp, Gs, Gs, Gd, Gd, Gd, Rd, Dd, Ds, Dd, Dd^Esd, Dd^Esd, Dd, Dd, Dd, Dd^Esd, Ds, Rd, Rd, Dd, Dd^Edp, Dd, Dd, Dd, Dd, Dd^Do, Dd, Dd
Gd, Gd, Gd, Gs, Gd, Gs, Gd, Gs, Gd, Gd, Gd, Gd, Ds, Gd, Rd, Rd, Dd, Dd, Dd, Dd, Dd, Dd, Dd, Dd^Esd, Dd, Dd, Dd, Rd, Rd, Dd^Vdt, Dd, Dd, Dd, Dd, Dd, Dd, Dd
Gd, Gd, Gd, Gd, Gd, Gd, Gd, Gd, Rd, Gd, Gd, Dd, Dd, Dd^Esd, Dd, Dd, Dd, Dd, Dd, Dd, Dd, Hd, Hd, Hd, Hd, Hd, Dd, Dd, Rd, Dd, Dd, Dd^Edpp, Dd, Dd^Esd, Dd^Vdt, Dd, Dd
Rd, Dd, Rd, Gd, Rd, Gd, Gd, Rd, Dd^Esd, Rd, Dd^Esd, Dd, Dd, Dd, Dd, Hd, Dd^Edpp, Dd, Dd, Dd^Do, Hd, Hd, Hd, Hd, Hd, Dd, Dd, Dd, Rd, Dd, Cer, Cer, Dd^Ecf, Hd, Hd, Hd, Dd^Edp
Dd, Dd, Dd, Rd, Ds, Ds, Dd, Ds, Dd, Dd, Dd, Dd, Dd, Dd, Hd, Hd, Hd, Dd^Edpp, Dd^Esd, Dd, Dd, Dd, Dd, Dd^Esd, Dd, Dd, Rd, Rd, Dd^Esd, Dd, Cer, 3 Ke, Dd^Edt, Hd, Hd, Hd, Dd
Dd, Dd, Dd, Dd, Hd, Dd, Dd, Dd, Dd, Dd, Dd^Vdt, Dd, Dd, Hd, Hd, Hd, Dd, Dd, Dd, Dd, Dd, Dd^Vdt, Dd, Dd, Dd, Rd, Dd^Esd, Dd, Dd, Dd^Edpp, Dd^Edt, Dd^Ecf, Dd^Edt, Hd, Dd, Dd, Dd
Hd, Hd, Hd, Hd, Hd, Hd, Dd, Dd, Dd^Dc, Dd^Edpp, Dd, Dd, Hd, Hd, Dd, Dd, Dd, Dd, Dd, Dd, Dd, Dd, Dd, Dd, Rd, Rd, Dd, Dd, Dd, Dd, Dd, Dd^Edt, Dd, Dd^Vdt, Dd, Dd, Dd
Hd, Hd, Hd, Dd, Dd, Dd, Cer, Dd, Dd^Edt, Dd, Dd, Hd, Dd, Hd, Dd, Dd, Dd, Dd, Cer, Cer, Cer, Dd^Edt, Rd^Edt, Rd, Dd, Dd, Dd, Dd, Dd, Dd, Dd, Dd, Hd, Dd, Dd, Dd, Dd
Hd, Hd, Dd^Vdt, Dd^Edp, Dd, Cer, 5 Ke, Cer, Dd^Edt, Dd^Edt, Dd, Dd, Dd, Dd, Dd^Vdt, Dd, Dd, Dd, Dd^Ecf, 4 Ke, Dd^Ecf, Dd^Edt, Rd, Dd, Dd, Dd, Dd, Dd^Vda, Dd, Dd, Dd, Dd, Hd, Dd, Dd, Dd, Hd
Hd, Hd, Dd, Dd, Dd, Dd^Ecf, Dd^Edt, Dd^Ecf, Dd^Edt, Dd, Dd, Dd, Dd, Dd, Dd, Dd, Hd, Dd, Dd, Dd, Dd, Dd^Edpp, Dd, Rd, Dd, Dd, Hd, Dd, Hd, Hd, Hd, Hd, Hd, Hd, Hd, Hd, Hd
Hd, Hd, Hd, Dd, Dd, Dd, Dd, Dd, Dd, Hd, Hd, Hd, Hd, Hd, Hd, Hd, Hd, Hd, Hd, Dd, Dd, Dd, Dd, Rd, Dd, Dd, Hd, Hd, Hd, Hd, Hd, Hd, Hd, Hd, Hd, Hd, Gd
Hd, Hd, Hd, Hd, Hd, Hd, Dd, Dd, Hd, Hd, Hd, Hd, Hd, Hd, Dd, Hd, Dd, Dd, Dd, Dd, Dd, Dd, Dd^Esd, Rd, Rd, Hd, Hd, Hd, Dd, Hd, Dd^Vda, Dd^Edp, Hd, Dd, Dd, Hd, Dd
Hd, Hd, Hd, Hd, Dd^Edp, Hd, Dd, Dd, Hd, Hd, Dd, Hd, Hd, Hd, Dd, Dd^Vda, Dd^Esd, Dd, Hd, Hd, Dd, Dd, Dd, Dd, Rd, Hd, Dd, Hd, Dd, Dd^Edt, Dd^Edt, Dd^Edt, Dd, Dd, Dd, Dd, Dd
Hd, Hd, Hd, Dd, Dd, Dd^Vdt, Dd^Edpp, Dd, Dd, Dd, Dd, Dd^Edp, Dd^Esd, Dd, Hd, Dd, Hd, Hd, Hd, Hd, Hd, Hd, Hd, Dd, Rd, Dd, Dd, Dd, Dd, Dd, Dd, Dd, Dd, Dd, Dd, Dd, Dd
Hd, Hd, Hd, Hd, Dd, Dd, Dd, Dd^Esd, Dd, Dd, Dd, Dd, Hd, Hd, Hd, Hd, Hd, Hd, Hd, Hd, Hd, Hd, Hd, Hd, Dd, Rd, Dd, Dd^Esd, Dd, Dd, Dd, Dd, Dd, Dd, Dd, Dd, Dd
