Dd, Dd, Dd, Dd, Hd, Hd, Hd, Hd, Hd, Hd, Hd, Hd, Hd, Hd, Dd, Dd, Dd, Dd^Edp, Hd, Hd, Hd, Hd, Dd, Dd, Dd, Dd^Edp, Dd, Dd, Hd, Hd, Hd, Hd, Hd, Hd, Hd, Hd
Dd, Dd, Dd, Hd, Dd, Hd, Hd, Hd, Hd, Hd, Hd, Dd, Dd, Dd, Dd, Dd, Hd, Hd, Hd, Hd, Hd, Hd, Dd, Dd, Dd^Vdt, Dd, Dd, Dd, Hd, Hd, Hd, Hd, Hd, Hd, Hd, Hd
Dd, Dd, Dd, Dd, Dd, Hd, Dd, Dd, Dd, Dd, Dd, Dd, Dd, Dd, Hd, Dd^Edpp, Hd, Hd, Hd, Hd, Dd, Dd, Dd^Dc, Dd, Dd, Dd, Dd, Dd, Hd, Hd, Hd, Hd, Hd, Hd, Dd, Dd
Dd, Dd, Dd, Dd^Vdt, Dd, Dd, Dd, Dd, Dd, Dd, Dd, Dd^Edpp, Dd, Dd, Hd, Hd, Cdr^Edt, Hd, Hd, Hd, Dd, Dd, Dd, Dd, Dd, Hd, Hd, Hd, Hd, Hd, Hd, Hd, Hd, Hd, Dd, Dd
Dd, Dd, Dd^Edpp, Dd, Dd, Dd, Dd, Dd, Hd, Dd, Dd^Edpp, Dd^Esd, Dd, Hd, Hd, Hd^Es, 1 Cdr, Cdr^Edt, Dd^Es, Hd, Dd^Edpp, Dd, Dd, Hd, Hd, Hd, Hd, Hd, Hd, Hd, Hd, Hd, Hd, Dd, Dd, Dd
Dd, Dd, Dd, Dd, Hd, Hd, Hd, Hd, Dd, Dd, Dd, Dd^Esd, Dd, Hd, Hd, Cdr^Edt, Cdr^Edt, Dd^Edt, Dd^Edt, Dd, Dd, Dd, Hd, Hd, Hd, Hd, Hd, Hd, Hd, Hd, Hd, Hd, Hd, Dd, Dd, Dd
Dd, Dd^Dc, Hd, Hd, Hd, Hd, Hd, Dd, Dd, Dd^Esd, Dd, Dd, Dd, Hd, Cdr, Hd, Dd^Es, Dd^Es, Dd, Dd, Dd, Hd, Hd, Hd, Hd, Hd, Dd, Hd, Dd, Hd, Dd, Hd, Dd, Dd, Hd, Hd
Dd, Dd, Hd, Hd, Hd, Hd, Hd, Dd, Dd^Do, Dd, Dd, Dd, Dd, Hd, Hd, Hd, Dd, Dd, Dd, Dd, Dd^Esd, Dd, Hd, Hd, Dd, Hd, Dd, Dd, Dd, Dd, Dd, Dd, Dd, Dd, Hd, Hd
Hd, Hd, Hd, Hd, Hd, Hd, Dd, Dd, Dd, Dd, Hd, Dd, Dd, Dd, Dd, Dd, Dd, Dd, Dd, Dd, Dd, Hd, Dd, Dd, Dd, Dd, Dd, Dd^Edp, Dd, Dd^Vdt, Dd, Dd^Esd, Hd, Hd, Hd, Hd
Hd, Hd, Hd, Hd, Hd, Hd, Dd, Dd, Dd, Dd, Hd, Dd, Dd, Dd, Dd, Dd, Dd, Dd, Dd, Dd, Dd, Dd, Rd, Dd, Dd, Dd, Dd, Dd, Dd, Dd, Dd, Dd, Hd, Hd, Hd, Hd
Hd, Hd, Hd, Hd, Hd, Dd, Dd, Dd, Hd, Hd, Hd, Hd, Dd, Dd, Dd, Dd, Dd^Esd, Dd, Rd, Dd, Rd, Rd, Cd, Rd, Rd, Rd, Rd, Rd, Rd, Rd, Rd, Dd, Rd, Dd, 4 Rd, Dd
Hd, Hd, Hd, Hd, Dd, Dd, Dd, Dd, Hd, Hd, Hd, Dd, Dd^Vdt, Dd, Rd, Rd, Rd, Rd, Dd, Rd, Dd, Rd^Es, Rd^Es, Rd^Es, Dd, Dd, Dd, Dd, Dd, Dd^Esd, Dd, Rd, Dd, Rd, Dd, Rd
Hd, Hd, Dd, Dd, Dd, Dd, Dd, Dd, Hd, Hd, Dd, Dd, Rd, Dd, Rd, Dd, Dd^Edpp, Dd, Hd, Dd, Hd, Dd^Esd, Rd, Dd, Dd, Dd, Dd, Hd, Hd, Hd, Dd, Dd, Dd, Dd, Dd, Dd
Dd, Dd, Dd, Dd, Dd, Dd, Dd, Hd, Dd, Hd, Dd, Rd, Dd^Edpp, Rd, Dd, Dd, Hd, Hd, Hd, Hd, Dd, Dd, Rd, Dd^Esd, Dd, Hd, Hd, Hd, Hd, Dd^Edpp, Dd, Dd, Dd, Dd, Dd, Dd
Dd, Dd, Dd, Dd, Dd, Dd, Rd, Dd, Rd, Dd, Rd, Rd, Dd, Dd, Dd, Hd, Hd, Hd, Dd, Dd, Rd, Dd, Rd, Dd, Hd, Hd, Hd, Hd, Dd, Dd, Dd, Dd^Dc, Dd, Dd, Dd^Es, Hhd
Dd, Dd, Dd, Dd, Rd, Rd, Dd, Rd, Dd, Rd, Dd, Dd, Hd, Hd, Hd, Hd, Hd, Hd, Dd, Rd, Dd^Vda, Rd, Dd, Dd, Hd, Hd, Hd, Hd, Dd, Dd, Dd^Vdt, Dd, Dd^Es, Hhd, Hhd, Hhd
Dd, Dd, Dd, Dd, Rd, Dd, Dd, Dd, Hd, Hd, Hd, Dd, Hd, Hd, Hd, Hd, Hd, Dd^Edp, Rd, Rd, Dd, Dd, Hd, Hd, Hd, Hd, Hd, Hd, Dd, Dd, Dd, Dd, Dd^Es, Hhd, Hhd, Hhd
Rd, Dd, Rd, Rd, Dd, Dd, Dd, Dd, Hd, Hd, Hd, Hd, Hd, Hd, Hd, Hd, Dd, Dd, Rd, Dd, Dd, Hd, Dd, Dd, Dd, Dd, Dd, Dd, Dd, Dd, Dd, Dd^Es, Hhd, Ds^Es, Hhd, Hhd
Dd, 3 Rd, Dd, Dd, Dd, Dd^Vdt, Dd, Hd, Hd, Hd, Hd, Hd, Dd, Hd, Dd, Hd, Dd, Dd^Esd, Rd, Dd, Dd, Dd, Dd, Dd, Dd, Dd, Dd^Edpp, Dd, Dd, Dd, Dd, Hhd, Mdd, Hhd, Mdd, Mdd
Dd, Dd, Dd, Dd^Edpp, Dd^Esd, Dd^Esd, Hd, Hd, Dd^Esd, Dd, Dd, Dd, Dd, Dd, Dd, Dd, Dd, Dd, Rd, Dd, Dd, Dd, Dd, Dd, Dd, Dd, Dd, Dd, Dd, Dd, Hhd, Hhd, Mdd, Mdd, Mdd, Mdd
Dd, Dd, Dd, Dd, Dd, Dd, Hd, Hd, Dd^Dc, Dd, Dd, Dd, Dd, Dd, Dd, Dd, Dd^Esd, Cd, Cd, Rd, Cd, Cd, Dd, Dd, Dd, Dd, Dd, Dd, Dd, Hhd, Dd, Hhd, Ds^Es, Ds^Es, Mdd, Mdd
Dd, Dd, Dd, Dd, Dd, Dd, Dd, Dd, Dd, Dd, Dd, Dd^Edp, Dd, Dd, Cd, Cd, Rd^Edt, Rd, Rd, Rd, Rd, Rd, Rd, Cd, Cd, Dd, Dd, Dd^Esd, Dd, Dd, Dd, Dd^Es, Ds^Es, Mdd, Mdd, Mdd
Dd, Dd, Dd, Dd, Dd, Dd^Edpp, Dd, Dd, Dd, Dd, Dd, Dd, Dd, Cd, Dd, Dd, Rd^Edt, Dd, Rd, Rd, Dd, Rd, Dd, Rd, Rd, Cd, Dd, Dd, Dd, Dd, Dd^Es, Ds, Hhd, Ds^Es, Mdd, Mdd
Dd, Dd, Dd, Dd, Rd, Dd, Dd, Dd, Dd, Dd, Cd, Cd, Rd, Rd^Es, Rd, Rd, Dd^Vda, Cd, Rd, Rd, Rd, Cd, Dd^Vda, Dd, Rd, Rd^Edt, Rd^Edt, Cd, Cd, Hhd, Hhd, Hhd, Mdd, Mdd, Mdd, Mdd
Rd, Rd, Rd, Rd, Dd^Esd, Rd, Rd, Dd, Dd^Ftd, Dd^Edp, Cd, Rd^Edt, Rd, Rd, Rd, Rd, Rd, Rd, Cd, Cd, Cd, Rd^Edt, Rd^Edt, Rd, Rd, Rd, Rd, Dd, Cd, Hhd, Hhd, Mdd, Hhd, Mdd, Hhd, Mdd
Dd, Dd^Esd, Dd, Dd^Ftd, Hd, Dd, Rd, Dd^Ftd, Dd^Ftd, Cd, Rd, Dd, Rd, Cdr^Eb, Rd, Dd^Vda, Dd, Rd, Cd, 2 Kd, Cd, Rd^Edt, Dd, Dd^Vda, Rd, Cdr^Eb, Rd, Rd, Rd, Cd, Hhd, Hhd, Hhd, Hhd, Hhd, Hhd
Dd, Hd, Hd, Hd, Hd, Dd^Ftd, Dd^Ftd, Rd, Rd, Cd, Rd, Rd, Rd, Rd, Rd, Rd^Edt, Rd, Rd, Rd, Cd, Rd, Rd, Rd, Rd, Rd, Rd^Edt, Dd, Rd, Rd, Cd, Rd, Rd, Rd, Rd, Rd, Hhd
Hd, Hd, Hd, Hd, Hd, Dd^Ftd, Dd^Ftd, Dd^Ftd, Dd^Ftd, Rd, Rd, Dd, Dd, Dd^Vda, Dd, Cd, Rd, Dd^Vda, Rd, Rd, Rd, Dd^Vda, Dd, Cd, Dd, Dd^Vda, Dd, Dd, Rd^Edt, Rd, Hhd, Hhd, Hhd, Hhd, Hhd, Rd
Hd, Hd, Hd, Hd, Hd, Hd, Dd^Ftd, Dd^Ftd, Dd^Ftd, Cd, Rd^Es, Dd, Gd, Dd, Dd, Dd, Dd^Vda, Rd^Es, Rd, Rd, Rd, Rd^Edt, Dd^Vda, Dd, Gd, Dd, Gd, Dd, Rd, Cd, Hhd, Hhd, Mdd, Mdd, Mdd, Hhd
Hd, Hd, Hd, Hd, Hd, Hd, Dd, Dd^Ftd, Dd^Ftd, Dd^Ftd, Rd, Gd, Gd, Gd, Gd, Gd, Dd, Rd, Rd, Rd, Rd, Rd, Gd, Gd, Gd, Gd, Gd, Gd, Rd, Hhd, Hhd, Hhd, Mdd, Mdd, Mdd, Mdd
