Dd, Dd, Hd, Hd, Hd, Dd, Dd, Dd, Dd, Dd, Dd, Dd, Dd, Dd, Dd, Dd, Dd, Dd, Dd^Edp, Dd, Rd, Dd, Dd, Dd, Hd, Hd, Hd, Dd, Dd, Dd, Dd, Dd, Dd, Dd, Hd, Dd
Hd, Hd, Hd, Hd, Dd, Dd, Dd, Dd, Dd, Dd, Dd^Edp, Dd^Edp, Dd^Edp, Dd^Edp, Dd, Dd, Dd, Dd^Edp, Dd^Edp, Ds^Edp, Dd, Dd, Hd, Hd, Hd, Hd, Dd, Dd, Dd, Dd, Dd, Dd, Hd, Hd, Hd, Hd
Hd, Hd, Hd, Dd, Dd, Dd^Edp, Dd, Dd, Dd, Dd, Dd, Dd, Dd, Dd, Dd, Dd, Dd, Dd^Edp, Dd, Dd, Ds, Dd, Hd, Hd, Hd, Dd, Dd, Dd, Dd, Dd, Hd, Hd, Hd, Hd, Hd, Hd
Hd, Hd, Dd, Dd, Dd, Dd, Dd, Dd, Hd, Hd, Hd, Hd, Dd, Dd^Esd, Dd, Dd, Cdr, Dd, Rd, Rd, Hd, Hd, Hd, Hd, Dd, Dd, Dd, Dd, Hd, Hd, Hd, Hd, Dd, Hd, Dd, Dd
Dd, Dd, Dd, Dd^Dc, Dd, Dd, Hd, Hd, Hd, Hd, Dd, Dd, Hd, Hd, Hd^Edp, Cdr^Esd, 1 Kdr, Cdr, Ds^Esd, Dd, Hd^Esd, Hd^Edp, Dd^Edp, Dd^Edp, Dd, Dd, Dd, Dd, Dd, Dd, Dd, Dd, Dd, Dd, Dd, Dd
Dd, Dd, Dd, Dd, Dd^Edp, Hd^Edp, Hd, Hd, Dd, Dd, Dd, Hd, Hd, Hd^Edp, Ds^Edp, Cdr^Esd, Cdr, Ds^Esd, Rd^Esd, Dd, Dd, Dd, Dd, Dd, Hd, Dd, Hd, Dd, Dd, Dd, Dd^Dc, Dd, Dd, Dd, Dd, Dd
Dd, Dd, Hd, Dd, Dd^Edp, Dd^Edp, Dd, Dd, Dd^Edp, Dd, Dd, Hd, Dd, Dd^Edp, Dd, Dd, Rd, Rd^Esd, Dd, Dd, Hd, Dd, Hd, Hd, Hd, Hd, Dd, Hd, Dd, Dd, Dd, Dd, Dd, Dd, Hd, Dd
Hd, Hd, Dd, Dd, Dd, Dd, Dd, Dd, Dd, Dd, Hd, Hd, Hd, Hd, Ds, Rd, Dd, Dd, Hd, Hd, Hd, Hd, Hd, Hd, Hd, Dd, Dd^Edpp, Dd, Dd, Dd, Hd, Dd, Hd, Hd, Hd, Hd
Hd, Hd, Hd, Hd, Dd, Dd, Dd, Dd, Hd, Hd, Hd, Hd, Dd, Dd, Ds, Dd, Dd, Dd, Hd, Hd, Dd, Hd, Dd, Hd, Dd, Dd, Dd, Dd, Hd, Hd, Hd, Hd, Hd, Hd, Hd, Dd
Hd, Hd, Hd, Hd, Dd^Dc, Dd, Dd, Hd, Dd, Dd, Dd, Dd, Dd, Dd, Rd, Dd, Dd, Hd, Dd^Edpp, Dd, Dd, Dd^Do, Dd, Dd, Dd, Dd, Dd^Esd, Dd, Dd, Dd, Dd, Dd, Dd^Edpp, Dd, Dd, Dd
Dd, Dd, Dd, Dd, Dd, Dd, Dd^Edp, Dd, Dd, Dd, Dd, Dd, Dd, Dd, Rd, Dd, Ds, Dd, Rd, Rd, Rd, Ds, Rd^Esd, Rd, Rd, Rd, Rd, Rd, Rd, Rd, Rd, Dd, Ds^Esd, Dd, 4 Rd, Ds
Dd, Dd, Dd, Dd, Dd, Dd, Dd, Dd, Hd, Dd, Hd, Dd^Edpp, Dd, Dd, Rd, Rd, Rd^Esd, Rd^Esd, Dd, Dd, Dd, Rd, Rd, Ds, Dd, Dd, Dd, Ds, Hd, Dd, Dd, Rd, Rd, Rd, Dd^Esd, Rd
Dd, Dd, Hd, Dd, Hd, Hd, Hd, Hd, Hd, Hd, Dd, Dd, Rd, Rd, Dd, Ds, Hd, Dd, Hd^Edpp, Hd, Dd, Ds, Rd, Dd, Hd, Hd, Hd, Hd, Dd, Dd^Edpp, Dd, Ds, Ds, Ds^Esd, Dd, Dd
Hd, Hd, Hd, Hd, Hd, Hd, Dd, Hd, Dd, Dd, Ds, Rd, Dd, Dd, Hd, Hd, Hd, Hd, Dd, Dd, Dd^Edpp, Dd, Rd, Hd, Hd, Hd, Dd, Hd, Dd, Dd, Dd, Dd, Dd, Dd, Hd, Hd
Hd, Hd, Hd, Hd, Dd, Hd, Rd, Dd, Dd, Dd, Rd, Rd, Hd, Hd, Dd, Hd, Dd, Dd, Dd, Dd, Dd, Dd, Rd, Hd, Dd, Dd, Dd, Dd, Dd, Dd, Dd, Dd, Hd, Hd, Hd, Hd
Dd, Hd, Dd, Dd, Rd, Rd, Ds^Esd, Rd, Rd, Rd, Dd, Dd^Edpp, Dd, Dd, Dd^Edpp, Dd, Dd, Dd, Ds, Ds, Rd, Rd, Dd^Esd, Dd^Esd, Dd^Do, Dd, Dd, Dd, Dd, Dd, Hd, Hd, Hd, Hd, Hd, Hd
Dd, Dd, Dd^Esd, Dd, Rd, Dd^Esd, Dd, Dd, Hd, Ds, Hd, Dd, Dd, Dd, Dd, Dd^Esd, Hd, Dd, Rd, Rd, Hd, Dd, Dd, Dd, Dd, Dd, Dd^Edpp, Dd, Dd^Dc, Dd, Dd, Dd, Dd, Dd, Dd, Dd
Rd, Ds, Rd, Rd, Dd, Dd, Hd, Hd, Hd, Hd, Dd, Dd, Dd, Dd, Dd, Dd, Hd, Hd, Rd, Ds, Hd, Hd, Hd, Hd, Dd, Dd, Dd, Dd, Dd, Dd, Dd, Dd, Dd, Dd^Edpp, Dd, Dd
Dd, 3 Rd, Dd, Dd, Hd^Edpp, Hd, Hd, Hd, Dd, Dd, Dd, Dd, Dd, Dd, Dd, Hd, Hd, Dd, Rd, Dd^Esd, Ds, Hd, Hd, Dd, Hd, Dd, Dd, Dd, Hd, Dd, Dd, Dd, Dd, Dd, Dd, Dd
Dd, Dd, Dd^Do, Dd, Dd, Dd, Dd, Dd, Dd, Dd, Hd, Hd, Dd, Dd, Hd, Hd, Hd, Hd, Ds, Rd, Ds, Dd, Dd, Dd, Hd, Dd, Dd, Dd, Hd, Dd, Hd, Dd, Dd, Dd, Dd, Dd
Dd, Dd, Dd, Dd, Dd, Dd, Dd, Dd, Dd, Dd, Hd, Hd, Hd, Dd, Dd, Hd, Hd, Cd, Kd, Rd, Kd, Cd, Dd, Dd, Hd, Hd, Hd, Dd, Dd, Hd, Hd, Hd, Hd^Edpp, Dd, Dd, Dd
Dd, Dd, Dd, Dd, Dd, Dd, Hd, Dd, Dd, Dd, Hd, Hd, Hd, Dd, Kd, Cd, Ds, Dd, Ds, Rd, Ds, Ds, Ds, Cd, Kd, Hd, Hd, Dd, Dd, Dd, Dd^Edpp, Hd, Dd^Edpp, Dd^Edpp, Hd, Dd
Dd, Dd, Dd, Dd, Dd, Dd, Dd, Dd, Dd, Hd, Hd, Hd, Hd, Cd, Ds, Rd, Rd, Rd, Rd, Rd, Rd, Rd, Rd, Rd, Ds, Cd, Dd, Dd, Dd, Dd, Dd^Edpp, Dd^Edpp, Hd^Edpp, Hd, Mdd, Hd
Dd, Dd, Ds, Dd, Rd, Dd, Dd, Dd^Ftd, Dd, Hd, Kd, Cd, Dd, Ds, Rd, Rd, Gd^Vda, Gd, Rd, Rd, Rd, Gd^Edpp, Gd^Vda, Rd, Rd, Ds, Dd, Cd, Kd, Hd^Edpp, Hd^Edpp, Dd^Edpp, Mdd, Mdd, Mdd, Mdd
Rd, Rd, Rd, Rd, Ds, Rd, Rd, Dd, Dd, Dd, Cd, Rd, Ds, Ds^Edpp, Rd, Gd^Edpp, Gd, Rd, Cd, Cd, Cd, Rd, Gd, Gd^Edpp, Rd, Ds^Edpp, Ds^Edpp, Ds, Cd, Hd^Edpp, Dd^Ftd, Mdd, Hd^Edpp, Mdd, Hd^Edpp, Mdd
Dd, Dd, Dd, Dd, Dd, Ds, Rd, Ds, Ds, Cd, Ds, Rd, Ds, Ds, Rd, Gd^Vda, Gd, Rd, Cd, 2 Kd, Cd, Rd, Gd^Edpp, Gd^Vda, Rd, Ds, Ds, Rd, Rd, Cd, Dd^Edpp, Dd^Ftd, Ds, Dd^Edpp, Dd, Dd
Hd, Hd, Hd, Hd, Hd, Dd, Dd, Rd, Rd, Cd, Rd, Rd, Rd, Rd, Gd^Edpp, Gd^Fts, Gd, Rd, Rd, Cd, Rd, Rd, Gd, Gd^Fts, Gd, Rd, Rd, Rd, Rd, Cd, Rd, Rd, Rd, Rd, Rd, Dd
Hd, Hd, Hd, Dd, Dd, Dd^Ftd, Dd^Ftd, Dd, Dd, Rd, Gd, Gd, Gd, Gd^Vda, Gd^Fts, Gd, Gd, Gd^Vda, Rd, Rd, Rd, Gd^Vda, Gd, Gd, Gd^Fts, Gd^Vda, Gd, Gd, Gd, Rd, Dd, Ds, Ds, Ds, Dd, Rd
Dd, Hd, Dd, Dd, Hd, Hd, Hd, Hd, Dd, Kd, Gd, Gd^Edpp, Gd, Gd^Fts, Gd^Fts, Gd, Gs^Vda, Rd, Rd, Rd, Rd, Rd, Gs^Vda, Gd^Fts, Gd^Fts, Gd, Gd^Fts, Gd, Gd, Kd, Dd, Dd^Ftd, Mdd, Mdd, Mdd, Dd
Dd, Dd, Dd, Hd, Hd, Hd, Hd, Hd, Dd, Dd, Dd, Gd, Gd^Fts, Gd^Fts, Dd, Gs, Dd, Rd, Dd, Rd, Dd, Rd, Gs, Gs, Gs, Gd^Fts, Gd^Fts, Gd^Fts, Dd, Dd, Dd, Dd, Mdd, Mdd, Mdd, Mdd
