Gs^Ft, Gs^Ft, Gs^Ft, Gs^Ft, Gd^Fts, Gs^Edpp, Gs^Edpp, Gs^Edpp, Gs^Edpp, Gs, Gs, Gs, Rd, Rr, Rp, Rr, Gs, Gs, Gs^Edpp, Gs, Gs^Ft, Gs^Ft, Gs^Ft, Gs, Gs^Ft, Gs^Ft, Gs^Ft, Gg, Gs^Ft
Gs^Ft, Gs^Ft, Gs^Ft, Gd^Fts, Gd^Fts, Gs^Edpp, Gs^Ft, Gs, Gd^Fts, Gs^Edpp, Gs, Gs, Rd, Rr, Rp, Rp, Gs^Edpp, Gs, Gd^Fts, Gd^Fts, Gd^Fts, Gs^Ft, Gs^Ft, Gs^Ft, Gs^Ft, Gs^Ft, Gs^Ft, Gs^Ft, Gs^Ft
Gs^Ft, Gs^Ft, Gs^Ft, Gs^Ft, Gs^Ft, Gs^Ft, Gd^Fts, Gs^Ft, Gs^Edpp, Gs, Gs^Edpp, Gs, Gs, Rr, Rr, Rd, Gs, Gs, Gs, Gs^Edpp, Gs^Edpp, Gd^Fts, Gs^Ft, Gs^Ft, Gs^Ft, Gs^Ft, Gs^Ft, Gs^Ft, Gs^Ft
Gs^Ft, Gs^Ft, Gs^Ft, Gd^Fts, Gd^Fts, Gd^Fts, Gd^Fts, Gs^Edpp, Gs, Gs, Gs^Vct, Ce, Gd^Ecf, Ce, Ce, Ce, Gd^Ecf, Ce, Gs^Vct, Gs, Gs, Gd^Fts, Gs^Edpp, Gd^Fts, Gs^Ft, Gs^Ft, Gs^Ft, Gs^Ft, Gd^Fts
Gs^Ft, Gs^Ft, Gd^Fts, Gs^Ft, Gs^Edpp, Gs^Edpp, Ce, Gs, Gs, Ce, Ce, Ce, Ce, Ce, 2 Ke, Ce, Ce, Ce, Ce, Ce, Gs, Gs, Ce, Gs, Gs^Edpp, Gd^Fts, Gs^Ft, Gd^Fts, Gd^Fts
Gd^Fts, Gd^Fts, Gd^Fts, Gs^Edpp, Re^Vct, Ce, 4 Ke, Ce, Re^Vct, Ce, Gd^Vct, Ce, Gd^Ecf, Ce, Ce, Ce, Gd^Ecf, Ce, Gs^Vct, Ce, Re^Vct, Ce, 3 Ke, Ce, Re^Vct, Gd^Fts, Gd^Fts, Gd^Fts, Gg^Edpp
Gs, Gs^Edpp, Gs^Edpp, Gs^Edpp, Ce, Ce, Ce, Ce, Ce, Gs, Gs, Ce, Gs^Edpp, Ce, Rp, Ce, Rd, Ce, Gs^Edpp, Gs^Edpp, Ce, Ce, Ce, Ce, Ce, Gs, Gs^Edpp, Gd^Edpp, Gd^Edpp
Gd^Fts, Gs^Edpp, Gs^Edpp, Gs, Gs, Gd^Ecf, Ce, Gd^Ecf, Gs, Gs, Ce, Gs^Edpp, Gd^Edpp, Rd, Rr, Rp, Rd, Gs, Ce, Gs^Edpp, Gs, Gd^Ecf, Ce, Gd^Ecf, Gs, Gs, Gs, Gd^Edpp, Gd^Edpp
Hhd, Hhd, Gs, Ce, Gs, Gs, Gd, Gs, Gd, Gd, Gd, Gd^Edpp, Gd, Rd, Rr, Rp, Gd, Gd, Gs, Gs, Gs, Gd, Gs, Gs, Gs, Ce, Gd, Gd, Gs^Fts
Mdd, Hhd, Hhd, Gd, Gd, Gd, Gd, Gd, Gd^Edpp, Gd, Gd, Gd, Gd, Rr, Rr, Rr, Rd, Gd, Gd^Edpp, Gd, Gd, Gs, Gd, Gd, Gd, Gs, Gd, Gd^Fts, Hhd^Fts
Mdd, Mdd, Hhd, Gd^Edpp, Gd^Edpp, Gd^Edpp, Gd, Gd, Gd, Gd^Edpp, Gd^Edpp, Gd, Rd, Rr, Rr, Rd, Rd, Gd, Gd, Gd, Gs^Gvs, Gd^Gvs, Gd^Edpp, Gd, Hhd^Edpp, Gd, Hhd, Hhd^Fts, Hhd^Fts
Mdd, Mdd, Mdd, Gd^Fts, Hhd, Hhd, Hhd, Gd, Gd^Edpp, Gd, Gd, Gd, Rd, Rr, Rr, Rr, Rd, Gd, Gd^Edpp, Gd, Gd, Gd^Gvs, Gd, Gd, Hhd^Edpp, Hhd, Mdd, Hhd, Mdd
Mdd, Mdd, Mdd, Hhd, Hhd^Fts, Mdd, Hhd^Esd, Gd^Edpp, Hhd, Gd^Edpp, Gd^Edpp, Gd, Gd, Rr, Rr, Rr, Gd, Gd, Gd^Edpp, Gd, Gd^Fts, Gd^Edpp, Gd, Hhd^Edpp, Hhd^Fts, Mdd, Mdd, Mdd, Mdd
Mdd, Hhd^Fts, Mdd, Hhd^Fts, Hhd^Fts, Mdd, Mv^Esd, Gd^Fts, Hhd, Gd, Gd, Gd, Rd, Rr, Rr, Rr, Gd, Gd^Gvs, Gd^Gvs, Gd^Gvs, Gd^Gvs, Gd^Edpp, Gd^Fts, Gd^Edpp, Hhd^Fts, Mdd^Esd, Mdd, Mdd, Mdd
Mdd, Hhd^Fts, Hhd^Fts, Hhd^Fts, Gd^Fts, Md, Md, Md^Esd, Hhd^Fts, Gd^Fts, Gd^Edpp, Gd, Rd, Rd, Rr, Rr, Rd, Gd^Gvs, Gd^Edpp, Gd^Edpp, Gd^Fts, Gd, Gd, Gd^Fts, Hhd^Fts, Mdd^Esd, Mdd^Esd, Mdd, Mdd
Mdd, Mdd, Mdd, Hhd^Fts, Gd^Fts, Hhd^Fts, Hhd^Fts, Mdd^Esd, Hhd^Fts, Hhd^Fts, Gd^Fts, Gd^Edpp, Gd, Rd, Rr, Rr, Rr, Gd, Gd, Gd^Fts, Gd^Fts, Gd^Edpp, Gd, Gd^Edpp, Gd^Fts, Hhd^Edpp, Hhd^Edpp, Mdd, Mdd
Mdd, Mdd, Mdd, Mdd, Gd^Edpp, Gd^Edpp, Hhd^Fts, Mdd^Esd, Hhd, Gd^Fts, Gd^Fts, Gd^Edpp, Gd, Rd, Rr, Rr, Rr, Gd, Gd, Gd^Edpp, Gd^Fts, Gd^Edpp, Gd, Gd, Hhd^Edpp, Hhd^Edpp, Hhd^Fts, Mdd, Mdd
Mdd, Mdd, Mdd^Esd, Mdd^Esd, Hhd, Gd, Gd, Hhd, Gd^Fts, Gd^Fts, Gd^Edpp, Gd, Gd^Fts, Gd, Rr, Rr, Rr, Rd, Gd, Gd, Gd^Gvs, Gd^Gvs, Gd^Fts, Gd^Fts, Hhd^Edpp, Mdd, Mdd, Mdd, Mdd
Mdd, Mdd, Hhd^Fts, Hhd^Fts, Gd^Fts, Gd, Gd, Hhd, Gd^Fts, Gd^Fts, Gd, Gd^Gvs, Gd^Gvs, Gd, Rd, Rr, Rr, Rd, Gd, Gd^Edpp, Gd, Gd^Gvs, Gd^Fts, Hhd^Fts, Hhd^Edpp, Mdd, Hhd^Edpp, Mdd, Mdd
Mdd, Mdd, Hhd^Fts, Gd^Fts, Gd^Fts, Gd^Fts, Gd^Edpp, Gd, Gd, Gd^Fts, Gd^Edpp, Gd, Gd^Fts, Gd, Gd, Rr, Rr, Rd, Gd, Gd^Gvs, Gd^Edpp, Gd, Gd^Gvs, Gd^Edpp, Gd^Fts, Hhd^Fts, Gd^Fts, Mdd, Mdd
Hhd^Fts, Mdd^Esd, Mdd, Hhd^Fts, Hhd, Gd^Fts, Gd^Fts, Gd^Edpp, Gd^Fts, Gd^Gvs, Gd, Gd^Fts, Gd^Fts, Gd, Gd, Rr, Rr, Rd, Rd, Gd^Edpp, Gd^Edpp, Gd, Gd, Gd, Gd^Fts, Hhd^Edpp, Gd^Fts, Mdd, Hhd^Fts
Hhd^Fts, Hhd^Fts, Hhd, Hhd, Gd^Fts, Gd^Fts, Gd^Edpp, Gd, Gd^Gvs, Gd^Fts, Gd, Gd^Fts, Gd^Edpp, Gd^Gvs, Gd^Vdr, Rd, Rr, 1 Rr, Rr, Gd, Gd, Gd^Gvs, Gd^Gvs, Gd^Gvs, Gd^Gvs, Gd^Edpp, Gd^Edpp, Hhd^Fts, Hhd^Fts
Hhd, Hhd, Gd^Fts, Hhd, Gd^Edpp, Gd^Edpp, Gd^Edpp, Gd, Gd^Gvs, Gd^Gvs, Gd^Fts, Gd^Edpp, Gd^Edpp, Gd^Gvs, Gd^Edb, Gd^Edb, Rd, Rr, Rr, Rd, Rd^Edb, Gd^Vdr, Gd^Edb, Gd^Gvs, Gd^Gvs, Gd^Edpp, Gd^Fts, Gd^Fts, Hhd^Fts
Gd^Fts, Gd^Fts, Gd^Fts, Gd^Edpp, Gd^Fts, Gd^Edpp, Gd^Edpp, Gd, Gd, Gd^Edpp, Gd, Gd, Gd, Gd, Gd^Edpp, Gd, Gd, Rr, Rr, Rr, Rd, Rd^Edb, Gd^Gvs, Gd^Gvs, Gd, Gd, Gd^Edpp, Gd^Fts, Gd^Fts
Gd, Gd^Fts, Gd, Gd^Fts, Gd, Gd^Edpp, Gd, Gd, Gd, Gd, Gd, Gd, Gd, Gd, Gd, Gd, Gd, Gd, Gd, Rr, Rr, Rd, Gd, Gd, Gd, Gd^Edpp, Gd, Gd^Fts, Gd^Fts
