Dd, Dd, Dd^Do, Dd, Dd, Dd, Dd, Dd, Dd, Dd, Hd, Hd, Dd, Dd, Hd, Hd, Hd, Hd, Ds, Rd, Ds, Dd, Dd, Dd, Hd, Dd, Dd, Dd, Hd, Dd, Hd, Dd, Dd, Dd, Dd, Dd
Dd, Dd, Dd, Dd, Dd, Dd, Hd, Hd, Dd^Dc, Dd, Dd, Dd, Dd, Dd, Dd, Dd, Dd^Esd, Cd, Cd, Rd, Cd, Cd, Dd, Dd, Dd, Dd, Dd, Dd, Dd, Hhd, Dd, Hhd, Ds^Es, Ds^Es, Mdd, Mdd
Dd, Dd, Dd, Dd, Dd, Dd, Dd, Dd, Dd, Dd, Dd, Dd^Edp, Dd, Dd, Cd, Cd, Rd^Edt, Rd, Rd, Rd, Rd, Rd, Rd, Cd, Cd, Dd, Dd, Dd^Esd, Dd, Dd, Dd, Dd^Es, Ds^Es, Mdd, Mdd, Mdd
Dd, Dd, Dd, Dd, Dd, Dd^Edpp, Dd, Dd, Dd, Dd, Dd, Dd, Dd, Cd, Dd, Dd, Rd^Edt, Dd, Rd, Rd, Dd, Rd, Dd, Rd, Rd, Cd, Dd, Dd, Dd, Dd, Dd^Es, Ds, Hhd, Ds^Es, Mdd, Mdd
Dd, Dd, Dd, Dd, Rd, Dd, Dd, Dd, Dd, Dd, Cd, Cd, Rd, Rd^Es, Rd, Rd, Dd^Vda, Cd, Rd, Rd, Rd, Cd, Dd^Vda, Dd, Rd, Rd^Edt, Rd^Edt, Cd, Cd, Hhd, Hhd, Hhd, Mdd, Mdd, Mdd, Mdd
Rd, Rd, Rd, Rd, Dd^Esd, Rd, Rd, Dd, Dd^Ftd, Dd^Edp, Cd, Rd^Edt, Rd, Rd, Rd, Rd, Rd, Rd, Cd, Cd, Cd, Rd^Edt, Rd^Edt, Rd, Rd, Rd, Rd, Dd, Cd, Hhd, Hhd, Mdd, Hhd, Mdd, Hhd, Mdd
Dd, Dd^Esd, Dd, Dd^Ftd, Hd, Dd, Rd, Dd^Ftd, Dd^Ftd, Cd, Rd, Dd, Rd, Cdr^Eb, Rd, Dd^Vda, Dd, Rd, Cd, Kd, Cd, Rd^Edt, Dd, Dd^Vda, Rd, Cdr^Eb, Rd, Rd, Rd, Cd, Hhd, Hhd, Hhd, Hhd, Hhd, Hhd
Dd, Hd, Hd, Hd, Hd^Ftd, Dd^Ftd, Dd^Ftd, Rd, Rd, Cd, Rd, Rd, Rd, Rd, Rd, Rd^Edt, Rd, Rd, Rd, Cd, Rd, Rd, Rd, Rd, Rd, Rd^Edt, Dd, Rd, Rd, Cd, Rd, Rd, Rd, Rd, Rd, Hhd
Hd, Hd, Hd, Hd, Hd, Dd^Ftd, Dd^Ftd, Dd^Ftd, Dd^Ftd, Rd, Rd, Dd, Dd, Dd^Vda, Dd, Cd, Rd, Dd^Vda, Rd, Rd, Rd, Dd^Vda, Dd, Cd, Dd, Dd^Vda, Dd, Dd, Rd^Edt, Rd, Hhd, Hhd, Hhd, Hhd, Hhd, Rd
Hd, Hd, Hd, Hd, Hd, Hd, Dd^Ftd, Dd^Ftd, Dd^Ftd, Cd, Rd^Es, Dd, Ds, Dd, Dd, Dd, Dd^Vda, Rd^Es, Rd, 2 Rd, Rd, Rd^Edt, Dd^Vda, Dd, Ds, Dd, Dd, Dd, Rd, Cd, Hhd, Hhd, Mdd, Mdd, Mdd, Hhd
Hd, Hd, Hd, Hd, Hd, Hd^Ftd, Dd^Ftd, Dd^Ftd, Dd^Ftd, Dd^Ftd, Rd, Gd, Dd, Dd, Ds, Dd, Dd, Rd, Rd, Rd, Rd, Rd, Ds, Gd, Gd, Dd, Ds, Dd, Rd, Hhd, Hhd, Hhd, Mdd, Mdd, Mdd, Mdd
Dd, Dd, Dd, Dd^Ftd, Dd^Ftd, Dd^Ftd, Dd^Ftd, Dd^Ftd, Dd^Ftd, Cd, Gd^Fts, Rd, Rd, Gd, Gd^Fts, Gd^Fts, Gd^Vda, Rd, Rd, Rd, Rd, Rd, Gd^Vda, Gd^Fts, Gd^Fts, Rd, Re^Gvs, Re^Gvs, Re^Gvs, Cd, Dd, Hhd, Ds^Es, Mdd, Mdd, Mdd
Dd, Hd, Dd, Dd, Dd^Ftd, Hd^Ftd, Hd, Hd^Ftd, Dd^Ftd, Cd, Gd^Fts, Gs^Ft, Gd^Vda, Gs^Ft, Gs^Ft, Gd, Rd, Rd, Rd, Rd, Rd, Rd, Rd, Gd^Fts, Gd, Rd, Re^Gvs, Gd^Wm, Re^Gvs, Cd, Dd, Ds^Es, Dd^Es, Mdd, Mdd, Mdd
Hd, Hd, Dd, Dd^Vdt, Dd, Hd, Ds, Hd, Dd^Ftd, Cd, Dd^Ftd, Dd, Dd, Gs^Ft, Rd, Rd, Gd^Fts, Rd, Ds, 1 Rd, Rd, Rd, Re^Gvs, Rd, Rd, Rd, Rd, Re^Gvs, Rd, Cd, Ds, Dd^Es, Mdd, Mdd, Mdd, Mdd
Dd, Dd, Hd, Dd^Edpp, Hd, Dd, Hd, Ds, Dd, Dd, Ds, Dd, Rd, Rd, Gd^Vda, Rd, Rd, Gs^Vda, Gd, Rd, Rd, Gd^Vda, Re^Gvs, Re^Gvs, Re^Gvs, Rd, Rd, Rd, Rd, Ds, Ds, Hhd, Hhd, Hhd, Hhd, Hhd
Dd, Dd, Hd, Hd, Hd, Hd, Dd, Hd, Dd, Cd, Ds, Gd^Vda, Rd, Gd^Fts, Rd, Rd, Gd^Fts, Gd^Fts, Gs^Ft, Gd^Fts, Re^Gvs, Re^Gvs, Wwf, Re^Gvs, Re^Gvs, Re^Gvs, Rd, Re^Eff, Re^Eff, Rd, Rd, Cd, Cd, Hhd, Hhd, Hhd
Dd, Dd, Ds, Ds, Ds, Dd, Dd, Dd, Dd, Dd, Dd, Ds, Rd, Rd, Gs^Ft, Gd^Fts, Gs^Ft, Gs^Ft, Wwt, Re^Gvs, Wwf, Wwf, Re^Gvs, Re^Gvs, Wwf, Re^Gvs, Rd, Re^Gvs, Re^Gvs, Re^Eff, Re^Gvs, Rd, Cd, Hhd, Dd, Hhd
Dd, Dd, Dd^Vdt, Ds, Dd, Dd^Edpp, Dd, Dd, Hd, Cd, Dd, Dd, Rd, Gd^Vda, Gs^Ft, Gs^Ft, Gs^Ft, Gs^Ft, Wwt, Wwt, Wwt, Re^Gvs, Wwt, Wwf, Re^Gvs, Re^Gvs, Rd, Re^Gvs, Dd^Vda, Re^Gvs, Re^Gvs, Rd, Dd, Dd, Dd, Dd
Dd, Dd, Dd, Dd, Hd, Hd, Hd, Hd, Hd, Cd, Ds, Gd^Fts, Rd, Dd, Dd, Gs^Ft, Wwt, Wwt, Wwt, Wot, Wwt, Wwt, Re^Gvs, Re^Gvs, Wwf, Re^Gvs, Rd, Re^Gvs, Ds, Dd, Rd, Rd, Dd, Ds, Dd, Dd
Dd, Dd, Dd, Dd, Hd, Hd, Dd, Hd, Dd, Cd, Rd, Rd, Rd, Dd, Gd^Vda, Gs^Ft, Gs^Ft, Gs^Ft, Gs^Ft, Wwt, Dd, Ds, Wwf, Wwf, Dd, Dd, Rd, Rd, Rd, Rd, Cd, Cd, Hd, Hd, Dd^Edpp, Dd
Ds, Dd, Dd, Hd, Dd, Dd, Dd, Dd, Dd, Dd, Rd, Cd, Rd, Ds, Rd, Gs^Ft, Gd^Fts, Gs^Ft, Gd^Fts, Gd^Fts, Dd, Dd, Dd, Dd, Dd, Ds, Rd, Cd, Rd, Cd, Dd^Edpp, Hd, Hd, Hd, Dd, Dd
Rd, Rd, Rd, Rd, Rd, Dd^Edpp, Rd, Rd, Rd, Rd, Dd, Rd, Cd, Dd, Dd, Rd, Rd, Ds, Rd, Ds, Rd, Dd, Rd, Rd, Rd, Rd, Cd, Rd, Rd, Dd^Edpp, Hd, Hd, Dd, Dd, Dd, Dd
Dd, Dd, Dd, Ds^Edpp, Dd, Rd, Ds, Ds, Hd^Edpp, Dd^Edpp, Hd, Dd, Dd, Cd, Cd, Ds, Cd, Rd, Cd, Rd, Cd, Rd, Cd, Ds, Cd, Cd, Dd, Dd, Rd, Dd, Dd, Dd, Hd, Dd^Vdt, Dd, Dd
Dd, Dd, Dd, Dd, Dd, Dd, Hd, Hd, Hd, Hd, Hd, Dd, Hd, Dd, Dd, Dd, Dd, Dd, Cd, Cd, Cd, Ds, Dd, Ds, Dd, Dd, Dd, Ds, Rd, Dd, Dd, Hd, Hd, Dd, Dd, Dd
Dd, Dd, Dd, Dd, Dd, Hd, Dd, Hd, Dd, Hd, Dd^Vdt, Hd, Dd, Dd, Hd, Hd, Dd, Dd, Dd, Dd, Dd, Dd, Hd, Hd, Hd, Hd, Dd^Edpp, Ds, Rd, Ds, Hd, Hd, Hd, Dd, Dd, Dd
Dd, Dd, Dd, Dd, Dd, Dd, Dd, Dd, Dd, Dd, Dd, Dd, Dd, Dd, Dd, Hd, Dd, Dd, Dd, Hd, Hd, Hd, Hd, Hd, Dd, Dd, Rd, Rd, Hd, Hd, Hd, Hd, Hd, Dd, Dd, Dd
Dd, Dd, Dd, Dd, Dd, Dd, Dd, Dd, Dd, Dd, Dd, Dd, Dd, Dd, Dd, Dd, Dd, Dd, Dd, Dd, Hd, Hd, Dd, Dd, Dd, Dd, Rd, Dd, Dd, Hd, Dd, Dd, Hd, Dd, Dd, Dd
