Dd, Dd, Dd^Do, Dd, Dd, Dd, Dd, Dd, Dd, Dd, Hd, Hd, Dd, Dd, Hd, Hd, Hd, Hd, Ds, Rd, Ds, Dd, Dd, Dd, Hd, Dd, Dd, Dd, Hd, Dd, Hd, Dd, Dd, Dd, Dd, Dd
Dd, Dd, Dd, Dd, Dd, Dd, Dd, Dd, Dd, Dd, Hd, Hd, Hd, Dd, Dd, Hd, Hd, Cd, Kd, Rd, Kd, Cd, Dd, Dd, Hd, Hd, Hd^Edpp, Dd, Dd, Hd, Hd, Hd, Hd^Edpp, Dd, Dd, Dd
Dd, Dd, Dd, Dd, Dd, Dd, Hd, Dd, Dd, Dd, Hd, Hd, Hd, Dd, Kd, Cd, Ds, Dd, Ds, Rd, Ds, Ds, Ds, Cd, Kd, Hd, Hd^Edpp, Dd^Edpp, Dd, Dd, Dd^Edpp, Hd, Dd^Edpp, Dd^Edpp, Hd, Dd
Dd, Dd, Dd, Dd, Dd, Dd, Dd, Dd, Dd, Hd, Hd, Hd, Hd, Cd, Ds, Rd, Rd, Rd, Rd, Rd, Rd, Rd, Rd, Rd, Ds, Cd, Dd, Dd, Dd, Dd, Dd^Edpp, Dd^Edpp, Hd^Edpp, Hd, Mdd, Hd
Dd, Dd, Ds, Dd, Rd, Dd, Dd, Dd^Ftd, Dd, Hd, Kd, Cd, Dd, Ds, Rd, Rd, Gd^Vda, Gd, Rd, Rd, Rd, Gd^Edpp, Gd^Vda, Rd, Rd, Ds, Dd, Cd, Kd, Hd^Edpp, Hd^Edpp, Dd^Edpp, Mdd, Mdd, Mdd, Mdd
Rd, Rd, Rd, Rd, Ds, Rd, Rd, Dd, Dd, Dd, Cd, Rd, Ds, Ds^Edpp, Rd, Gd^Edpp, Gd, Rd, Cd, Cd, Cd, Rd, Gd, Gd^Edpp, Rd, Ds^Edpp, Ds^Edpp, Ds, Cd, Hd^Edpp, Dd^Ftd, Mdd, Hd^Edpp, Mdd, Hd^Edpp, Mdd
Dd, Dd, Dd, Dd^Edpp, Dd, Ds, Rd, Ds, Ds, Cd, Ds, Rd, Ds, Ds, Rd, Gd^Vda, Gd, Rd, Cd, Kd, Cd, Rd, Gd^Edpp, Gd^Vda, Rd, Ds, Ds, Rd, Rd, Cd, Dd^Edpp, Dd^Ftd, Ds, Dd^Edpp, Dd, Dd
Hd, Hd, Hd, Hd, Hd, Dd, Dd, Rd, Rd, Cd, Rd, Rd, Rd, Rd, Rd, Gd^Fts, Gd, Rd, Rd, Cd, Rd, Rd, Gd, Gd^Fts, Rd, Rd, Rd, Rd, Rd, Cd, Rd, Rd, Rd, Rd, Rd, Dd
Hd, Hd, Hd, Dd, Dd^Edpp, Dd^Ftd, Dd^Ftd, Dd, Dd, Rd, Gd, Gd, Rd, Gd^Vda, Gd^Fts, Rd, Rd, Gd^Vda, Rr, Rd, Rr, Gd^Vda, Rd, Rd, Gd, Gd, Rd, Gd^Gvs, Gd^Gvs, Rd, Dd, Ds, Ds, Ds, Dd, Rd
Dd, Hd, Dd, Dd, Hd^Edpp, Hd^Edpp, Hd, Hd, Dd, Kd, Gd, Rd, Gd^Edpp, Gd^Fts, Gd^Fts, Gd, Gs^Vda, Rr, Rr, 2 Rr, Rr, Rr, Gs^Vda, Gd^Fts, Gd^Fts, Rd, Gd^Gvs, Gd^Wm, Gd^Gvs, Kd, Dd, Dd^Ftd, Mdd, Mdd, Mdd, Dd
Dd, Dd, Dd, Hd, Hd, Hd, Hd, Hd, Ds, Ds, Ds, Rd, Gd^Fts, Gd^Fts, Gd^Edpp, Gs, Rd, Rr, Rr, Rr, Rr, Rr, Rd, Gd^Edpp, Gd^Edpp, Rd, Gd^Gvs, Gd, Ds, Ds, Ds, Dd, Mdd, Mdd, Mdd, Mdd
Dd, Dd, Dd, Ds, Dd, Dd, Dd, Dd, Dd, Cd, Gd, Rd, Rd, Gd^Edpp, Gd^Fts, Gd^Fts, Gd^Vda, Rr, Rr, Rr, Rr, Rr, Gs^Vda, Gd^Fts, Gd^Fts, Rd, Gd^Gvs, Gd^Gvs, Gd^Gvs, Cd, Dd, Dd, Hd, Hd, Dd, Dd
Dd, Hd, Dd, Dd, Dd, Hd, Hd, Hd, Dd, Kd, Gd, Gd^Fts, Gd^Vda, Gd, Gd^Fts, Gd, Rd, Rr, Rr, Rr, Rr, Rr, Rd, Gd^Fts, Gs, Rd, Gd^Gvs, Gd^Wm, Gd^Gvs, Kd, Hd, Hd, Hd, Hd, Dd, Dd
Hd, Hd, Dd, Dd^Vdt, Dd, Hd, Ds, Hd, Dd, Cd, Ds, Gd, Gd, Gd^Edpp, Rd, Rd, Gs^Edpp, Rd, Rd, 1 Rr, Rd, Rd, Gs^Gvs, Rd, Rd, Rd, Rd, Gd^Gvs, Ds, Cd, Ds, Hd, Dd, Ds, Dd, Dd
Dd, Dd, Hd, Dd^Edpp, Hd, Dd, Hd, Ds, Dd, Dd, Ds, Gd^Edpp, Rd, Rd, Gs^Vda, Rd, Rd, Gs^Vda, Gs, Rd, Rd, Gs^Vda, Gs^Gvs, Gs^Gvs, Gs^Gvs, Rd, Rd, Rd, Rd, Ds, Ds, Dd, Hd, Hd, Dd, Hd
Dd, Dd, Hd, Hd, Hd, Hd, Dd, Hd, Dd, Kd, Ds, Gd^Vda, Rd, Gs, Rd, Rd, Gs, Gd^Fts, Gs^Ft, Gd^Fts, Rd, Gs^Gvs, Gd^Gvs, Gs^Gvs, Gs^Gvs, Gs^Gvs, Rd, Gd^Eff, Gd^Eff, Rd, Rd, Kd, Cd, Dd^Edpp, Dd, Dd
Dd, Dd, Ds, Ds, Ds, Dd, Dd, Dd, Dd, Dd, Gd^Edpp, Ds, Rd, Rd, Gs, Gd^Fts, Gd^Fts, Gs^Ft, Wwt, Ds, Ds, Gd^Gvs, Gd^Gvs, Gs^Gvs, Gd^Gvs, Gs^Gvs, Rd, Gd^Gvs, Gd^Gvs, Gd^Eff, Gd^Gvs, Rd, Kd, Hd, Dd, Dd
Dd, Dd, Dd^Vdt, Ds, Dd, Dd^Edpp, Dd, Dd, Hd, Cd, Gd, Gd, Rd, Gs^Vda, Gd^Edpp, Gs^Edpp, Gd^Fts, Gs^Ft, Wwt, Wwt, Wwt, Ds, Wwt, Gs^Gvs, Gs^Gvs, Gd^Gvs, Rd, Gd^Gvs, Gs^Vc, Gd^Gvs, Gd^Gvs, Rd, Dd, Dd, Dd, Dd
Dd, Dd, Dd, Dd, Hd, Hd, Hd, Hd, Hd, Kd, Ds, Gd, Rd, Gs, Gd^Fts, Gs^Edpp, Wwt, Wwt, Wwt, Wot, Wwt, Wwt, Wwt, Gd^Gvs, Gd^Gvs, Gs^Gvs, Rd, Gd^Gvs, Gd^Gvs, Gd^Gvs, Rd, Rd, Dd, Ds, Dd, Dd
Dd, Dd, Dd, Dd, Hd, Hd, Dd, Hd, Dd, Cd, Rd, Rd, Rd, Gd, Gd^Vda, Gs, Gd^Fts, Gs^Ft, Gs^Ft, Wwt, Gd^Gvs, Ds, Gd^Gvs, Gs^Gvs, Gd^Gvs, Gd^Gvs, Rd, Rd, Rd, Rd, Cd, Kd, Hd, Hd, Dd^Edpp, Dd
Ds, Dd, Dd, Hd, Dd, Dd, Dd, Dd, Dd, Dd, Rd, Kd, Rd, Ds, Rd, Gd^Edpp, Gd^Fts, Gd^Fts, Gd^Fts, Gd^Gvs, Gd^Gvs, Gd^Gvs, Gd^Gvs, Gd^Gvs, Gd^Gvs, Ds, Rd, Kd, Rd, Kd, Dd^Edpp, Hd, Hd, Hd, Dd, Dd
Rd, Rd, Rd, Rd, Rd, Dd^Edpp, Rd, Rd, Rd, Rd, Dd, Rd, Cd, Gd, Gd, Rd, Rd, Gd^Fts, Rd, Gd, Rd, Rd, Rd, Rd, Rd, Ds, Cd, Rd, Rd, Dd^Edpp, Hd, Hd, Dd, Dd, Dd, Dd
Dd, Dd, Dd, Ds^Edpp, Dd, Rd, Ds, Ds, Hd^Edpp, Dd^Edpp, Hd, Dd, Dd, Kd, Cd, Ds, Kd, Rd, Cd, Rd, Cd, Ds, Kd, Ds, Cd, Kd, Dd, Dd, Rd, Dd, Dd, Dd, Hd, Dd^Vdt, Dd, Dd
Dd, Dd, Dd, Dd, Dd, Dd, Hd, Hd, Hd, Hd, Hd, Dd, Hd, Dd, Dd, Dd, Dd, Dd, Cd, Kd, Cd, Ds, Dd, Ds, Dd, Dd, Dd, Ds, Rd, Dd, Dd, Hd, Hd, Dd, Dd, Dd
Dd, Dd, Dd, Dd, Dd, Hd, Dd, Hd, Dd, Hd, Dd^Vdt, Hd, Dd, Dd, Hd, Hd, Dd, Dd, Dd, Dd, Dd, Dd, Hd, Hd, Hd, Hd, Dd^Edpp, Ds, Rd, Ds, Hd, Hd, Hd, Dd, Dd, Dd
Dd, Dd, Dd, Dd, Dd, Dd, Dd, Dd, Dd, Dd, Dd, Dd, Dd, Dd, Dd, Hd, Dd, Dd, Dd, Hd, Hd, Hd, Hd, Hd, Dd, Dd, Rd, Rd, Hd, Hd, Hd, Hd, Hd, Dd, Dd, Dd
Dd, Dd, Dd, Dd, Dd, Dd, Dd, Dd, Dd, Dd, Dd, Dd, Dd, Dd, Dd, Dd, Dd, Dd, Dd, Dd, Hd, Hd, Dd, Dd, Dd, Dd, Rd, Dd, Dd, Hd, Dd, Dd, Hd, Dd, Dd, Dd
