Dd, Dd, Dd^Do, Dd, Dd, Dd, Dd, Dd, Dd, Dd, Hd, Hd, Dd, Dd, Hd, Hd, Hd, Hd, Ds, Rd, Ds, Dd, Dd, Dd, Hd, Dd, Dd, Dd, Hd, Dd, Hd, Dd, Dd, Dd, Dd, Dd
Dd, Dd, Dd, Dd, Dd, Dd, Dd, Dd, Dd, Dd, Hd, Hd, Hd, Dd, Dd, Hd, Hd, Cdr, Kdr, Rd, Kdr, Cdr, Dd, Dd, Hd, Hd, Hd^Edpp, Dd, Dd, Hd, Hd, Hd, Hd^Edpp, Dd, Dd, Dd
Dd, Dd, Dd, Dd, Dd, Dd, Hd, Dd, Dd, Dd, Hd, Hd, Hd, Dd, Kdr, Cdr, Ds, Dd^Edt, Ds, Rd, Ds, Ds, Ds, Cdr, Kdr, Hd, Hd^Edpp, Dd^Edpp, Dd, Dd, Dd^Edpp, Hd, Dd^Edpp, Dd^Edpp, Hd, Dd
Dd, Dd, Dd, Dd, Dd, Dd, Dd, Dd, Dd, Hd, Hd, Hd, Hd, Cdr, Ds, Rd, Rd, Rd, Rd, Rd, Rd, Rd, Rd, Rd, Ds, Cdr, Dd, Dd, Dd, Dd, Dd^Edpp, Dd^Edpp, Hd^Edpp, Hd, Mdd, Hd
Dd, Dd, Ds, Dd, Rd, Dd, Dd, Dd^Ftd, Dd, Hd, Kdr, Cdr, Dd^Edt, Ds, Rd, Rd, Gd^Dr, Gd, Rd, Rd, Rd, Rb^Fdw, Gd^Vdr, Rd, Rd, Ds^Edt, Dd, Cdr, Kdr, Hd^Edpp, Hd^Edpp, Dd^Edpp, Mdd, Mdd, Mdd, Mdd
Rd, Rd, Rd, Rd, Ds, Rd, Rd, Dd, Dd, Dd, Cdr^Edt, Rd^Esd, Ds, Ds^Edpp, Rd, Gll^Fdw, Gd, Rd, Cdr^Edt, Cdr^Edt, Cdr^Edt, Rd, Gd, Rb^Fdw, Rd^Esd, Ds^Edpp, Ds^Edpp, Ds, Cdr, Hd^Edpp, Dd^Ftd, Mdd, Hd^Edpp, Mdd, Hd^Edpp, Mdd
Dd, Dd, Dd, Dd^Edpp, Dd, Ds, Rd, Ds, Ds, Cdr, Ds^Edt, Rd^Esd, Ds^Esd, Ds^Edt, Rd, Gd^Vdr, Gd, Rd, Cdr^Edt, Kdr, Cdr^Edt, Rd^Esd, Gd^Esd, Gd^Dr, Rd, Ds, Ds, Rd, Rd, Cdr, Dd^Edpp, Dd^Ftd, Ds, Dd^Edpp, Dd, Dd
Hd, Hd, Hd, Hd, Hd, Dd, Dd, Rd, Rd, Cdr, Rd, Rd, Rd, Rd, Rd, Gd^Fts, Gd^Esd, Rd^Esd, Rd^Esd, Cdr^Edt, Rd, Rd^Esd, Rb, Rb^Fdw, Rd, Rd, Rd, Rd, Rd, Cdr, Rd, Rd, Rd, Rd, Rd, Dd
Hd, Hd, Hd, Dd, Dd^Edpp, Dd^Ftd, Dd^Ftd, Dd, Dd, Rd, Gd, Gd^Edt, Rd, Gd^Vdr, Rb^Fdw, Rd, Rd^Edt, Rb^Vdr, Rr^Edt, Rd, Rr, Rb^Dr, Rd, Rd, Rb^Edt, Rb^Edt, Rd, Rb^Edb, Rb^Edb, Rd, Dd, Ds, Ds, Ds, Dd, Rd
Dd, Hd, Dd, Dd, Hd^Edpp, Hd^Edpp, Hd, Hd, Dd, Kdr^Esd, Gd, Rd, Rb^Fdw, Rb^Fdw, Rb^Fdw, Rb, Rb^Dr, Rr^Edt, Rr, 2 Rr, Rr, Rr^Edt, Rb^Dr, Rb^Fdw, Rb^Fdw, Rd, Rb^Edb, Rb^Dr, Rb^Edb, Kdr, Dd, Dd^Ftd, Mdd, Mdd, Mdd, Dd
Dd, Dd, Dd, Hd, Hd, Hd, Hd, Hd, Ds, Ds, Ds, Rd, Rb^Fdw, Rb^Fdw, Rb^Edpp, Rb, Rd, Rr, Rr, Rr, Rr, Rr, Rd, Rb^Fdw, Rb^Fdw, Rd, Rb^Edb, Rb^Edb, Ds, Ds, Ds, Dd, Mdd, Mdd, Mdd, Mdd
Dd, Dd, Dd, Ds, Dd, Dd, Dd, Dd, Dd, Cdr^Esd, Gd^Esd, Rd, Rd, Rb^Edpp, Rb^Fdw, Rb^Fdw, Rb^Vdr, Rr, Rr, Rr, Rr, Rr, Rb^Vdr, Rb^Fdw, Rb^Fdw, Rd, Rb^Edb, Rb^Edb, Rb^Edb, Cdr, Dd, Dd, Hd, Hd, Dd, Dd
Dd, Hd, Dd, Dd, Dd, Hd, Hd, Hd, Dd, Kdr^Esd, Gd, Gd^Fdw, Gd^Vdr, Gd, Rb^Fdw, Rb, Rd^Edt, Rr, Rr, Rr, Rr, Rr, Rd^Edt, Rb^Fdw, Rb^Edt, Rd, Rb^Edb, Rb^Dr, Rb^Edb, Kdr, Hd, Hd, Hd, Hd, Dd, Dd
Hd, Hd, Dd, Dd^Vdt, Dd, Hd, Ds, Hd, Dd, Cdr^Esd, Ds, Gd, Gd, Gd^Edpp, Rd, Rd, Rb^Fdw, Rd, Rd, 1 Rr, Rd, Rd, Rb^Edb, Rd, Rd, Rd, Rd, Rb^Edb, Ds^Esd, Cdr^Esd, Ds, Hd, Dd, Ds, Dd, Dd
Dd, Dd, Hd, Dd^Edpp, Hd, Dd, Hd, Ds, Dd, Dd, Ds, Gd^Edpp, Rd, Rd, Rb^Dr, Rd, Rd, Rb^Dr, Rb, Rd, Rd, Rb^Dr, Rb^Edb, Rb^Edb, Rb^Edb, Rd, Rd, Rd, Rd, Ds, Ds, Dd, Hd, Hd, Dd, Hd
Dd, Dd, Hd, Hd, Hd, Hd, Dd, Hd, Dd, Kdr, Ds, Gd^Dr, Rd, Rb, Rd, Rd, Rb, Rb^Fdw, Rb^Fdw, Rb^Fdw, Rd, Rb^Edb, Rb^Edb, Rb^Edb, Rb^Edb, Rb^Edb, Rd, Rb^Edb, Rb^Edb, Rd, Rd, Kdr^Esd, Cdr^Esd, Dd^Edpp, Dd, Dd
Dd, Dd, Ds, Ds, Ds, Dd, Dd, Dd, Dd, Dd, Gd^Esd, Ds, Rd, Rd, Rb^Edt, Rb^Fdw, Rb^Fdw, Rb^Fdw, Ds, Ds, Ds, Rb^Edb, Rb^Edb, Rb^Edb, Rb^Edb, Rb^Edb, Rd, Rb^Edb, Rb^Edb, Rb^Edb, Rb^Edb, Rd^Esd, Kdr^Esd, Hd, Dd, Dd
Dd, Dd, Dd^Vdt, Ds, Dd, Dd^Edpp, Dd, Dd, Hd, Cdr^Esd, Gd^Esd, Gd, Rd, Rb^Vdr, Rb^Edpp, Rb^Edpp, Rb^Fdw, Rb^Fdw, Ds, Ds, Ds, Ds, Ds, Rb^Edb, Rb^Edb, Rb^Edb, Rd, Rb^Edb, Rb^Dr, Rb^Edb, Rb^Edb, Rd^Esd, Dd^Esd, Dd, Dd, Dd
Dd, Dd, Dd, Dd, Hd, Hd, Hd, Hd, Hd, Kdr, Ds, Gd, Rd, Rb^Edt, Rb^Fdw, Rb^Edpp, Ds, Ds, Ds, Wot^Dr, Ds, Ds, Ds, Rb^Edb, Rb^Edb, Rb^Edb, Rd, Rb^Edb, Rb^Edb, Rb^Edb, Rd, Rd, Dd, Ds, Dd, Dd
Dd, Dd, Dd, Dd, Hd, Hd, Dd, Hd, Dd, Cdr, Rd, Rd, Rd, Gd, Gd^Vdr, Rb, Rb^Fdw, Rb^Fdw, Rb^Fdw, Ds, Rb^Edb, Ds, Rb^Edb, Rb^Edb, Rb^Edb, Rb^Edb, Rd, Rd, Rd, Rd, Cdr, Kdr, Hd, Hd, Dd^Edpp, Dd
Ds, Dd, Dd, Hd, Dd, Dd, Dd, Dd, Dd, Dd, Rd, Kdr, Rd, Ds, Rd, Rb^Fdw, Rb^Fdw, Rb^Fdw, Rb^Fdw, Rb^Edb, Rb^Edb, Rb^Edb, Rb^Edb, Rb^Edb, Rb^Edb, Ds, Rd, Kdr, Rd, Kdr, Dd^Edpp, Hd, Hd, Hd, Dd, Dd
Rd, Rd, Rd, Rd, Rd, Dd^Edpp, Rd, Rd, Rd, Rd, Dd, Rd, Cdr, Gd^Esd, Gd^Esd, Rd, Rd, Rb^Fdw, Rd, Gd, Rd, Rd^Esd, Rd, Rd^Esd, Rd^Esd, Ds, Cdr, Rd, Rd, Dd^Edpp, Hd, Hd, Dd, Dd, Dd, Dd
Dd, Dd, Dd, Ds^Edpp, Dd, Rd, Ds, Ds, Hd^Edpp, Dd^Edpp, Hd, Dd, Dd, Kdr, Cdr, Ds, Kdr, Rd^Esd, Cdr^Esd, Rd, Cdr^Esd, Ds, Kdr^Esd, Ds, Cdr^Esd, Kdr, Dd, Dd, Rd, Dd, Dd, Dd, Hd, Dd^Vdt, Dd, Dd
Dd, Dd, Dd, Dd, Dd, Dd, Hd, Hd, Hd, Hd, Hd, Dd, Hd, Dd, Dd, Dd, Dd, Dd, Cdr, Kdr, Cdr, Ds, Dd, Ds, Dd, Dd, Dd, Ds, Rd, Dd, Dd, Hd, Hd, Dd, Dd, Dd
Dd, Dd, Dd, Dd, Dd, Hd, Dd, Hd, Dd, Hd, Dd^Vdt, Hd, Dd, Dd, Hd, Hd, Dd, Dd, Dd, Dd, Dd, Dd, Hd, Hd, Hd, Hd, Dd^Edpp, Ds, Rd, Ds, Hd, Hd, Hd, Dd, Dd, Dd
Dd, Dd, Dd, Dd, Dd, Dd, Dd, Dd, Dd, Dd, Dd, Dd, Dd, Dd, Dd, Hd, Dd, Dd, Dd, Hd, Hd, Hd, Hd, Hd, Dd, Dd, Rd, Rd, Hd, Hd, Hd, Hd, Hd, Dd, Dd, Dd
Dd, Dd, Dd, Dd, Dd, Dd, Dd, Dd, Dd, Dd, Dd, Dd, Dd, Dd, Dd, Dd, Dd, Dd, Dd, Dd, Hd, Hd, Dd, Dd, Dd, Dd, Rd, Dd, Dd, Hd, Dd, Dd, Hd, Dd, Dd, Dd
