Dd, Dd, Dd^Do, Dd, Dd, Dd, Dd, Dd, Dd, Dd, Hd, Hd, Dd, Dd, Hd, Hd, Hd, Hd, Ds, Rd, Ds, Dd, Dd, Dd, Hd, Dd, Dd, Dd, Hd, Dd, Hd, Dd, Dd, Dd, Dd, Dd
Dd, Dd, Dd, Dd, Dd, Dd, Hd, Hd, Dd^Dc, Dd, Dd, Dd, Dd, Dd, Dd, Dd, Dd^Esd, Cdr, Cdr, Rd, Cdr, Cdr, Dd, Dd, Dd, Dd, Dd, Dd, Dd, Hhd, Dd, Hhd, Ds^Es, Ds^Es, Mdd, Mdd
Dd, Dd, Dd, Dd, Dd, Dd, Dd, Dd, Dd, Dd, Dd, Dd^Edp, Dd, Dd, Cdr, Cdr, Rd^Edt, Rd, Rd, Rd, Rd, Rd, Rd, Cdr, Cdr, Dd, Dd, Dd^Esd, Dd, Dd, Dd, Dd^Es, Ds^Es, Mdd, Mdd, Mdd
Dd, Dd, Dd, Dd, Dd, Dd^Edpp, Dd, Dd, Dd, Dd, Dd, Dd, Dd, Cdr, Dd, Dd, Rd^Edt, Dd, Rd, Rd, Dd, Rd, Dd^Edb, Rd, Rd, Cdr, Dd, Dd, Dd, Dd, Dd^Es, Ds, Hhd, Ds^Es, Mdd, Mdd
Dd, Dd, Dd, Dd, Rd, Dd, Dd, Dd, Dd, Dd, Cdr, Cdr, Rd, Rd^Es, Rd, Rd, Dd^Vdr, Cdr, Rd, Rd, Rd, Cdr, Dd^Vdr, Dd^Edb, Rd, Rd^Edt, Rd^Edt, Cdr, Cdr, Hhd, Hhd, Hhd, Mdd, Mdd, Mdd, Mdd
Rd, Rd, Rd, Rd, Dd^Esd, Rd, Rd, Dd, Dd^Ftd, Dd^Edp, Cdr, Rd^Edt, Rd, Rd, Rd, Rd, Rd, Rd, Cdr, Cdr, Cdr, Rd^Edt, Rd^Edt, Rd, Rd, Rd, Rd, Dd, Cdr, Hhd, Hhd, Mdd, Hhd, Mdd, Hhd, Mdd
Dd, Dd^Esd, Dd, Dd^Ftd, Hd, Dd, Rd, Dd^Ftd, Dd^Ftd, Cdr, Rd, Dd, Rd, Cdr^Eb, Rd, Dd^Vdr, Dd, Rd, Cdr, Kd, Cdr, Rd^Edt, Dd, Dd^Dr, Rd, Cdr^Eb, Rd, Rd, Rd, Cdr, Hhd, Hhd, Hhd, Hhd, Hhd, Hhd
Dd, Hd, Hd, Hd, Hd^Ftd, Dd^Ftd, Dd^Ftd, Rd, Rd, Cdr, Rd, Rd, Rd, Rd, Rd, Rd^Edt, Rd, Rd, Rd, Cdr, Rd, Rd, Rd, Rd, Rd, Rd^Edt, Dd, Rd, Rd, Cdr, Rd, Rd, Rd, Rd, Rd, Hhd
Hd, Hd, Hd, Hd, Hd, Dd^Ftd, Dd^Ftd, Dd^Ftd, Dd^Ftd, Rd, Rd, Dd^Edb, Dd^Edb, Dd^Vdr, Dd^Edb, Cdr, Rd, Dd^Vdr, Rd, Rd, Rd, Dd^Vdr, Dd, Cdr, Dd, Dd^Vdr, Dd^Edb, Dd^Edb, Rd^Edb, Rd, Hhd, Hhd, Hhd, Hhd, Hhd, Rd
Hd, Hd, Hd, Hd, Hd, Hd, Dd^Ftd, Dd^Ftd, Dd^Ftd, Cdr, Rd^Es, Dd^Edb, Ds, Dd^Edb, Dd^Edb, Dd^Edb, Dd^Vdr, Rd^Es, Rd, 2 Rd, Rd, Rd^Edt, Dd^Edt, Dd, Ds^Edt, Dd, Dd^Edb, Dd^Edb, Rd, Cdr, Hhd, Hhd, Mdd, Mdd, Mdd, Hhd
Hd, Hd, Hd, Hd, Hd, Hd^Ftd, Dd^Ftd, Dd^Ftd, Dd^Ftd, Dd^Ftd, Rd, Gd, Dd^Edb, Dd^Edb, Ds, Dd^Edb, Dd^Edb, Rd, Rd, Rd^Edb, Rd^Edt, Rd^Edt, Ds^Edt, Gd^Edt, Gd, Dd^Edb, Ds^Edt, Dd^Edb, Rd, Hhd, Hhd, Hhd, Mdd, Mdd, Mdd, Mdd
Dd, Dd, Dd, Dd^Ftd, Dd^Ftd, Dd^Ftd, Dd^Ftd, Dd^Ftd, Dd^Ftd, Cdr, Gd^Fts, Rd, Rd, Gd, Gd^Fts, Gd^Fts, Gd^Vdr, Rd, Rd^Edb, Rd^Edb, Rd^Edb, Rd^Edt, Gd^Vdr, Gd^Fts, Gd^Fts, Rd, Rb, Rb, Rb, Cd, Dd, Hhd, Ds^Es, Mdd, Mdd, Mdd
Dd, Hd, Dd, Dd, Dd^Ftd, Hd^Ftd, Hd, Hd^Ftd, Dd^Ftd, Cdr, Gd^Fts, Gs^Ft, Gd^Vdr, Gs^Ft, Gs^Ft, Gd^Edb, Rd, Rd, Rd, Rd, Rd, Rd, Rd, Gd^Fts, Gd, Rd, Rb, Gd^Dr, Rb, Cd, Dd, Ds^Es, Dd^Es, Mdd, Mdd, Mdd
Hd, Hd, Dd, Dd^Vdt, Dd, Hd, Ds, Hd, Dd^Ftd, Cdr, Dd^Ftd, Dd, Dd^Edb, Gs^Ft, Rd^Edb, Rd^Edb, Gd^Fts, Rd, Ds, 1 Rd, Rd, Rd^Edb, Rb^Edb, Rd, Rd^Edb, Rd^Edb, Rd, Rb, Rd, Cd, Ds, Dd^Es, Mdd, Mdd, Mdd, Mdd
Dd, Dd, Hd, Dd^Edpp, Hd, Dd, Hd, Ds, Dd, Dd, Ds, Dd, Rd^Edb, Rd^Edb, Gd^Vdr, Rd, Rd, Gs^Vdr, Gd^Edb, Rd, Rd, Gd^Dr, Rb, Rb^Edb, Rb^Edt, Rd^Edb, Rd, Rd, Rd, Ds, Ds, Hhd, Hhd, Hhd, Hhd, Hhd
Dd, Dd, Hd, Hd, Hd, Hd, Dd, Hd, Dd, Cdr, Ds, Gd^Dr, Rd^Edb, Gd^Fts, Rd^Edb, Rd, Gd^Fts, Gd^Fts, Gs^Ft, Gd^Fts, Rb, Rb, Wwf^Edb, Rb^Edb, Rb^Edb, Rb^Edt, Rd^Edb, Rb^Eff, Rb^Eff, Rd, Rd, Cdr, Cdr, Hhd, Hhd, Hhd
Dd, Dd, Ds, Ds, Ds, Dd, Dd, Dd, Dd, Dd, Dd, Ds^Edb, Rd^Edb, Rd^Edb, Gs^Ft, Gd^Fts, Gs^Ft, Gs^Ft, Wwt, Rb, Wwf, Wwf, Rb^Edb, Rb^Edb, Wwf, Rb^Edt, Rd^Edb, Rb^Edb, Rb^Edb, Rb^Eff, Rb, Rd, Cdr, Hhd, Dd, Hhd
Dd, Dd, Dd^Vdt, Ds, Dd, Dd^Edpp, Dd, Dd, Hd, Cdr, Dd, Dd, Rd, Gd^Vdr, Gs^Ft, Gs^Ft, Gs^Ft, Gs^Ft, Wwt, Wwt, Wwt^Edb, Rb, Wwt, Wwf, Rb, Rb^Edb, Rd, Rb, Dd^Vdr, Rb, Rb^Edt, Rd, Dd, Dd, Dd, Dd
Dd, Dd, Dd, Dd, Hd, Hd, Hd, Hd, Hd, Cdr, Ds, Gd^Fts, Rd, Dd^Edb, Dd, Gs^Ft, Wwt, Wwt, Wwt, Wot, Wwt^Edb, Wwt, Rb, Rb, Wwf, Rb^Edb, Rd^Edb, Rb^Edb, Ds^Edb, Dd^Edb, Rd^Edt, Rd^Edt, Dd, Ds, Dd, Dd
Dd, Dd, Dd, Dd, Hd, Hd, Dd, Hd, Dd, Cdr, Rd, Rd, Rd^Edb, Dd, Gd^Vdr, Gs^Ft, Gs^Ft, Gs^Ft, Gs^Ft, Wwt^Edb, Dd^Edb, Ds^Edb, Wwf, Wwf, Dd, Dd, Rd^Edb, Rd^Edb, Rd, Rd^Edb, Cdr, Cdr, Hd, Hd, Dd^Edpp, Dd
Ds, Dd, Dd, Hd, Dd, Dd, Dd, Dd, Dd, Dd, Rd, Cdr, Rd, Ds^Edb, Rd, Gs^Ft, Gd^Fts, Gs^Ft, Gd^Fts, Gd^Fts, Dd, Dd, Dd^Edb, Dd^Edb, Dd^Edb, Ds^Edb, Rd, Cdr, Rd, Cdr, Dd^Edpp, Hd, Hd, Hd, Dd, Dd
Rd, Rd, Rd, Rd, Rd, Dd^Edpp, Rd, Rd, Rd, Rd, Dd, Rd, Cdr, Dd^Edb, Dd^Edb, Rd^Edb, Rd, Ds, Rd, Ds, Rd, Dd, Rd^Edb, Rd^Edb, Rd, Rd, Cdr, Rd, Rd, Dd^Edpp, Hd, Hd, Dd, Dd, Dd, Dd
Dd, Dd, Dd, Ds^Edpp, Dd, Rd, Ds, Ds, Hd^Edpp, Dd^Edpp, Hd, Dd, Dd, Cdr, Cdr, Ds, Cdr, Rd, Cdr, Rd, Cdr, Rd, Cdr, Ds, Cdr, Cdr, Dd, Dd, Rd, Dd, Dd, Dd, Hd, Dd^Vdt, Dd, Dd
Dd, Dd, Dd, Dd, Dd, Dd, Hd, Hd, Hd, Hd, Hd, Dd, Hd, Dd, Dd, Dd, Dd, Dd, Cdr, Cdr, Cdr, Ds, Dd, Ds, Dd, Dd, Dd, Ds, Rd, Dd, Dd, Hd, Hd, Dd, Dd, Dd
Dd, Dd, Dd, Dd, Dd, Hd, Dd, Hd, Dd, Hd, Dd^Vdt, Hd, Dd, Dd, Hd, Hd, Dd, Dd, Dd, Dd, Dd, Dd, Hd, Hd, Hd, Hd, Dd^Edpp, Ds, Rd, Ds, Hd, Hd, Hd, Dd, Dd, Dd
Dd, Dd, Dd, Dd, Dd, Dd, Dd, Dd, Dd, Dd, Dd, Dd, Dd, Dd, Dd, Hd, Dd, Dd, Dd, Hd, Hd, Hd, Hd, Hd, Dd, Dd, Rd, Rd, Hd, Hd, Hd, Hd, Hd, Dd, Dd, Dd
Dd, Dd, Dd, Dd, Dd, Dd, Dd, Dd, Dd, Dd, Dd, Dd, Dd, Dd, Dd, Dd, Dd, Dd, Dd, Dd, Hd, Hd, Dd, Dd, Dd, Dd, Rd, Dd, Dd, Hd, Dd, Dd, Hd, Dd, Dd, Dd
