Hd, Hd, Hd, Hd, Hd, Hd, Hd, Hd, Dd, Dd, Dd, Hd, Rd, Rd, Dd, Dd, Dd, Dd, Dd, Dd, Dd, Dd, Dd, Dd, Hd, Hd, Hd, Hd, Hd
Hd, Hd, Hd, Hd, Hd, Hd, Hd, Dd, Dd, Dd, Hd, Dd, Rd, Rd, Rd, Dd, Dd, Dd, Dd, Dd, Dd, Dd, Dd, Hd, Hd, Hd, Hd, Hd, Hd
Dd, Hd, Dd, Hd, Hd, Hd, Dd^Edpp, Dd, Dd, Hd, Hd, Dd, Dd, Rd, Rd, Dd, Dd, Dd, Dd, Dd, Dd, Dd, Hd, Hd, Hd, Hd, Hd, Hd, Dd
Dd, Dd, Hd, Hd, Hd, Hd, Dd, Dd, Hd, Hd, Dd^Vdt, Ce, Dd^Ecf, Ce, Ce, Ce, Dd^Ecf, Ce, Dd^Vdt, Dd, Dd, Hd, Dd, Hd, Dd, Dd, Dd, Dd, Hd
Dd, Hd, Dd, Hd, Dd, Dd, Ce, Dd, Dd, Ce, Ce, Ce, Ce, Ce, 2 Ke, Ce, Ce, Ce, Ce, Ce, Dd, Dd, Ce, Dd, Dd, Dd, Hd, Dd, Hd
Dd, Dd, Dd, Dd, Dd^Vdt, Ce, 4 Ke, Ce, Dd^Vdt, Ce, Dd^Vdt, Ce, Dd^Ecf, Ce, Ce, Ce, Dd^Ecf, Ce, Dd^Vdt, Ce, Dd^Vdt, Ce, 3 Ke, Ce, Dd^Vdt, Dd, Hd, Hd, Hd
Hd, Dd, Hd, Dd, Ce, Ce, Ce, Ce, Ce, Dd, Dd, Ce, Rd, Ce, Rd, Ce, Rd, Ce, Dd, Dd, Ce, Ce, Ce, Ce, Ce, Hd, Hd, Hd, Hd
Hd, Hd, Hd, Dd, Dd, Dd^Ecf, Ce, Dd^Ecf, Dd, Dd^Edpp, Ce, Dd, Dd, Rd, Rr, Rd, Dd, Dd, Ce, Dd, Dd, Dd^Ecf, Ce, Dd^Ecf, Dd, Dd, Dd^Esd, Dd, Hd
Hhd, Hhd, Hd, Ce, Dd, Dd^Esd, Hd, Hd, Dd, Dd, Dd^Edpp, Dd, Dd, Rd, Rr, Dd, Dd, Dd, Dd, Dd, Dd, Dd, Dd, Dd, Dd, Ce, Dd, Dd^Es, Hhd
Mdd, Hhd, Hhd, Hd, Dd, Dd, Hd, Hd, Dd, Hd, Hd, Dd, Dd, Rd, Rd, Dd, Dd^Vda, Hd, Hd, Hd, Dd, Dd, Dd, Dd, Dd, Ds, Ds, Hhd, Hhd
Mdd, Mdd, Hhd, Hd, Hhd, Dd, Dd, Dd, Dd, Hd, Dd, Dd, Dd, Dd, Rr, Rd, Dd, Dd, Hd, Hd, Hd, Dd, Dd, Dd, Hhd^Edpp, Ds^Es, Hhd, Hhd, Hhd
Mdd, Mdd, Mdd, Hhd, Mdd, Mdd, Hhd, Dd^Ftd, Dd^Ftd, Dd, Hd, Dd, Cdr^Es, Rd, Rr, Rd, Dd, Dd, Hd, Hd, Hhd, Ds, Ds, Dd^Es, Hhd^Edpp, Hhd, Mdd, Hhd, Mdd
Mdd, Mdd, Mdd, Hhd, Hhd, Mdd, Mdd, Dd^Ftd, Hhd, Hd, Hd, Hd, Rd^Edt, Rd^Edt, Rr, Dd, Dd, Hd, Hd, Hd, Hhd, Hhd, Ds^Es, Hhd^Edpp, Hhd^Fts, Mdd, Mdd, Mdd, Mdd
Mdd, Ds^Es, Mdd, Hhd, Hhd, Mdd, Mv, Mdd, Mdd, Hhd, Hd, Dd, Dd, Rr^Edt, Rd, Dd, Cdr, Hd, Dd^Edp, Dd, Dd^Edp, Dd, Hhd, Dd^Es, Hhd^Fts, Mdd^Esd, Mdd, Mdd, Mdd
Mdd, Dd, Ds^Es, Ds^Es, Dd, Mdd, Mdd, Mdd, Hhd, Hhd, Dd^Ftd, Ds, Dd^Vda, Rr, Rr, Rd, Cdr^Es, Cdr, Dd, Dd, Hhd, Dd^Esd, Ds^Es, Hhd, Hhd^Fts, Mdd^Esd, Mdd^Esd, Mdd, Mdd
Mdd, Mdd, Mdd, Dd^Es, Dd^Es, Hhd, Hhd, Mdd^Esd, Hhd, Hhd^Ftd, Dd^Ftd, Hd, Dd, Dd, Rd, Rd^Edt, Rd^Edt, Rd^Edt, Hd, Hhd, Hhd, Hhd, Ds^Es, Dd, Hhd, Hhd^Edpp, Hhd^Edpp, Mdd, Mdd
Mdd, Mdd, Mdd, Mdd, Hhd, Rd, Hhd, Mdd^Esd, Hhd^Ft, Dd^Ft, Dd^Ftd, Dd^Ftd, Ds, Dd, Rd, Rd, Dd, Dd^Esd, Hd, Hd, Hhd, Hhd, Dd, Ds^Es, Hhd, Hhd^Edpp, Hhd^Fts, Mdd, Mdd
Mdd, Mdd, Mdd^Esd, Mdd^Esd, Hhd, Rd, Rd, Hhd, Dd^Ftd, Dd^Ft, Dd^Ftd, Ds, Dd^Ftd, Dd, Dd, Rr, Rd, Dd, Dd, Dd, Dd, Dd, Hhd, Hhd, Hhd, Mdd, Mdd, Mdd, Mdd
Mdd, Mdd, Hhd, Hhd^Ftd, Dd^Ftd, Hhd, Rd, Hhd, Dd^Ftd, Dd^Ftd, Hd, Hd, Hd, Hd, Dd, Rr, Rr, Dd, Dd, Dd, Dd, Dd, Hhd, Hhd, Hhd^Edpp, Mdd, Ds^Es, Mdd, Mdd
Mdd, Mdd, Hhd, Dd^Ftd, Dd^Ftd, Dd^Ftd, Dd^Ft, Rd, Dd, Dd^Ftd, Ds, Ds, Dd^Ftd, Ds, Ds, Rd, Rr, Dd, Hd, Hd, Dd^Esd, Ds, Ds, Hhd, Hhd, Hhd, Dd^Es, Mdd, Mdd
Hhd, Mdd^Esd, Mdd, Hhd, Hhd^Ftd, Dd^Ft, Dd^Ft, Dd^Ftd, Dd^Ftd, Dd, Dd, Dd^Ftd, Dd^Ftd, Ds, Dd, Rd, Rd, Dd, Dd, Hd, Hd, Dd, Dd, Dd, Hhd, Hhd, Dd, Mdd, Hhd^Fts
Hhd, Hhd, Hhd^Ftd, Hhd, Dd^Ftd, Dd^Ft, Dd^Ftd, Dd^Ftd, Dd^Ftd, Dd^Ftd, Dd, Dd^Ftd, Ds, Dd^Edp, Dd^Vda, Dd, Rd, 1 Rr, Dd, Hd, Hd, Dd, Dd, Dd, Dd, Ds, Dd^Es, Ds^Es, Hhd^Fts
Hhd, Hhd^Ftd, Dd^Ftd, Hhd, Hd, Dd^Ftd, Hd, Dd^Esd, Ds, Ds, Dd^Ftd, Dd, Dd, Dd^Do, Dd, Dd, Dd, Rr, Rr, Dd, Dd, Dd^Vda, Hd, Dd, Dd, Ds, Hhd, Hhd, Hhd
Dd^Ft, Dd^Ftd, Dd^Ftd, Hd, Dd^Ftd, Hd, Hd, Hd, Dd, Ds, Hd, Hd, Hd, Hd, Hd, Hd, Dd, Rd, Rr, Rd, Rd, Dd, Hd, Hd, Dd^Esd, Dd, Hhd, Hhd, Hhd
Gd^Ft, Dd^Ft, Gd, Dd^Ftd, Gd, Hd, Dd, Dd, Dd, Hd, Dd, Hd, Hd, Hd, Hd, Hd, Dd, Dd, Dd, Rd, Rd, Dd, Dd, Dd, Dd, Dd, Hhd, Hhd, Hhd
